Row Labels;4TC_PCURMON;4TC_P+1MON;Days until M CURM;Days until M +1MON;CURM days away;1MON  days away;22;Total days;Perpetual
10/09/2009;20056;19683;20;51;2;29;;31;20032
11/09/2009;19745;19160;19;50;3;28;;31;19688
14/09/2009;19568;18960;16;47;6;25;;31;19450
15/09/2009;19335;18458;15;46;7;24;;31;19137
16/09/2009;19568;18661;14;45;8;23;;31;19334
17/09/2009;19688;18913;13;44;9;22;;31;19463
18/09/2009;19650;18713;12;43;10;21;;31;19348
21/09/2009;19610;18443;9;40;13;18;;31;19121
22/09/2009;19520;17925;8;39;14;17;;31;18800
23/09/2009;19468;17598;7;38;15;16;;31;18563
24/09/2009;19540;17903;6;37;16;15;;31;18695
25/09/2009;19480;17995;5;36;17;14;;31;18666
28/09/2009;19425;17855;2;33;20;11;;31;18412
29/09/2009;19458;17970;1;32;21;10;;31;18450
30/09/2009;18815;18080;0;31;22;9;;31;18293
01/10/2009;19375;18560;30;60;8;38;;46;19233
02/10/2009;19113;18288;29;59;7;37;;44;18982
05/10/2009;19050;18300;26;56;4;34;;38;18971
06/10/2009;19438;18878;25;55;3;33;;36;19391
07/10/2009;20223;19525;24;54;2;32;;34;20182
08/10/2009;20450;19660;23;53;1;31;;32;20425
09/10/2009;20456;19462;22;52;0;30;;30;20456
12/10/2009;20718;19600;19;49;3;27;;30;20606
13/10/2009;20135;19180;18;48;4;26;;30;20008
14/10/2009;20595;19605;17;47;5;25;;30;20430
15/10/2009;21030;20185;16;46;6;24;;30;20861
16/10/2009;21230;20160;15;45;7;23;;30;20980
19/10/2009;21713;20613;12;42;10;20;;30;21346
20/10/2009;21915;21128;11;41;11;19;;30;21626
21/10/2009;22188;22050;10;40;12;18;;30;22133
22/10/2009;22315;22805;9;39;13;17;;30;22527
23/10/2009;22415;23053;8;38;14;16;;30;22713
26/10/2009;22358;23178;5;35;17;13;;30;22823
27/10/2009;22258;23010;4;34;18;12;;30;22709
28/10/2009;22190;22770;3;33;19;11;;30;22557
29/10/2009;22414;23700;2;32;20;10;;30;23271
30/10/2009;25233;24133;1;31;21;9;;30;24463
02/11/2009;26300;25005;28;59;6;37;;43;26119
03/11/2009;25044;23203;27;58;5;36;;41;24819
04/11/2009;26472;24806;26;57;4;35;;39;26301
05/11/2009;26844;25139;25;56;3;34;;37;26706
06/11/2009;29250;27313;24;55;2;33;;35;29139
09/11/2009;30238;28315;21;52;1;30;;31;30176
10/11/2009;30608;28938;20;51;2;29;;31;30500
11/11/2009;31560;30185;19;50;3;28;;31;31427
12/11/2009;31920;30510;18;49;4;27;;31;31738
13/11/2009;32170;31215;17;48;5;26;;31;32016
16/11/2009;32410;31490;14;45;8;23;;31;32173
17/11/2009;32688;32180;13;44;9;22;;31;32541
18/11/2009;34270;35250;12;43;10;21;;31;34586
19/11/2009;32555;32310;11;42;11;20;;31;32468
20/11/2009;31845;31495;10;41;12;19;;31;31710
23/11/2009;31540;30300;7;38;15;16;;31;30940
24/11/2009;31634;30415;6;37;16;15;;31;31005
25/11/2009;31215;28910;5;36;17;14;;31;29951
26/11/2009;31050;26681;4;35;18;13;;31;28513
27/11/2009;30972;25778;3;34;19;12;;31;27789
30/11/2009;26500;24425;0;31;22;9;;31;25027
01/12/2009;28660;26475;30;61;8;39;;47;28288
02/12/2009;30860;28190;29;60;7;38;;45;30445
03/12/2009;30250;27750;28;59;6;37;;43;29901
04/12/2009;30222;27911;27;58;5;36;;41;29940
07/12/2009;29465;27113;24;55;2;33;;35;29331
08/12/2009;29585;26693;23;54;1;32;;33;29497
09/12/2009;29738;26935;22;53;0;31;;31;29738
10/12/2009;29428;26300;21;52;1;30;;31;29327
11/12/2009;29028;25620;20;51;2;29;;31;28808
14/12/2009;29160;25413;17;48;5;26;;31;28556
15/12/2009;29528;26120;16;47;6;25;;31;28868
16/12/2009;29500;25885;15;46;7;24;;31;28684
17/12/2009;29225;25538;14;45;8;23;;31;28274
18/12/2009;29125;25595;13;44;9;22;;31;28100
21/12/2009;29048;25445;10;41;12;19;;31;27653
22/12/2009;29223;25886;9;40;13;18;;31;27824
23/12/2009;29480;26700;8;39;14;17;;31;28225
24/12/2009;27278;26333;7;38;15;16;;31;26821
29/12/2009;27653;26725;2;33;20;11;;31;27054
30/12/2009;28097;27383;1;32;21;10;;31;27613
31/12/2009;28875;28239;0;31;22;9;;31;28424
04/01/2010;30775;29556;27;55;5;33;;38;30615
05/01/2010;30545;29113;26;54;4;32;;36;30386
06/01/2010;30525;29145;25;53;3;31;;34;30403
07/01/2010;30830;29268;24;52;2;30;;32;30732
08/01/2010;31405;29683;23;51;1;29;;30;31348
11/01/2010;31740;29820;20;48;2;26;;28;31603
12/01/2010;31130;29160;19;47;3;25;;28;30919
13/01/2010;30145;27690;18;46;4;24;;28;29794
14/01/2010;30388;27958;17;45;5;23;;28;29954
15/01/2010;30208;28035;16;44;6;22;;28;29742
18/01/2010;30097;27672;13;41;9;19;;28;29318
19/01/2010;29553;26855;12;40;10;18;;28;28589
20/01/2010;29750;27225;11;39;11;17;;28;28758
21/01/2010;30285;28450;10;38;12;16;;28;29499
22/01/2010;30295;28760;9;37;13;15;;28;29582
25/01/2010;30273;28533;6;34;16;12;;28;29279
26/01/2010;30208;27950;5;33;17;11;;28;28837
27/01/2010;30285;27278;4;32;18;10;;28;28352
28/01/2010;30150;25818;3;31;19;9;;28;27210
29/01/2010;24980;23680;2;30;20;8;;28;24051
01/02/2010;24430;23295;27;58;5;36;;41;24292
02/02/2010;25433;24730;26;57;4;35;;39;25361
03/02/2010;25597;25214;25;56;3;34;;37;25566
04/02/2010;25938;25743;24;55;2;33;;35;25927
05/02/2010;26378;26360;23;54;1;32;;33;26377
08/02/2010;26293;26328;20;51;2;29;;31;26295
09/02/2010;25490;25333;19;50;3;28;;31;25475
10/02/2010;24730;24468;18;49;4;27;;31;24696
11/02/2010;24760;24508;17;48;5;26;;31;24719
12/02/2010;25213;25298;16;47;6;25;;31;25229
15/02/2010;25244;25433;13;44;9;22;;31;25299
16/02/2010;25455;26243;12;43;10;21;;31;25709
17/02/2010;25913;26873;11;42;11;20;;31;26254
18/02/2010;25425;26438;10;41;12;19;;31;25817
19/02/2010;25413;26510;9;40;13;18;;31;25873
22/02/2010;25573;26580;6;37;16;15;;31;26093
23/02/2010;25455;26218;5;36;17;14;;31;25873
24/02/2010;25503;26480;4;35;18;13;;31;26070
25/02/2010;25758;27513;3;34;19;12;;31;26834
26/02/2010;27460;27305;2;33;20;11;;31;27360
01/03/2010;28198;27953;30;60;8;38;;46;28155
02/03/2010;28978;28568;29;59;7;37;;44;28913
03/03/2010;31315;30500;28;58;6;36;;42;31199
04/03/2010;32294;31094;27;57;5;35;;40;32144
05/03/2010;31913;31015;26;56;4;34;;38;31818
08/03/2010;31248;30390;23;53;1;31;;32;31221
09/03/2010;30470;29533;22;52;0;30;;30;30470
10/03/2010;31398;30635;21;51;1;29;;30;31373
11/03/2010;32060;31273;20;50;2;28;;30;32008
12/03/2010;32958;32142;19;49;3;27;;30;32876
15/03/2010;32638;32055;16;46;6;24;;30;32521
16/03/2010;32263;31553;15;45;7;23;;30;32097
17/03/2010;32945;32218;14;44;8;22;;30;32751
18/03/2010;32950;32380;13;43;9;21;;30;32779
19/03/2010;32963;32735;12;42;10;20;;30;32887
22/03/2010;32910;32778;9;39;13;17;;30;32853
23/03/2010;32633;32173;8;38;14;16;;30;32418
24/03/2010;32493;31830;7;37;15;15;;30;32162
25/03/2010;31940;30820;6;36;16;14;;30;31343
26/03/2010;31775;30650;5;35;17;13;;30;31138
29/03/2010;31873;30203;2;32;20;10;;30;30760
30/03/2010;32125;30090;1;31;21;9;;30;30701
31/03/2010;30139;29261;0;30;22;8;;30;29495
01/04/2010;30711;29569;29;60;7;38;;45;30533
06/04/2010;30713;29783;24;55;2;33;;35;30660
07/04/2010;30803;30190;23;54;1;32;;33;30784
08/04/2010;31163;30310;22;53;0;31;;31;31163
09/04/2010;31403;30373;21;52;1;30;;31;31370
12/04/2010;30925;29115;18;49;4;27;;31;30691
13/04/2010;31495;30050;17;48;5;26;;31;31262
14/04/2010;31750;30653;16;47;6;25;;31;31538
15/04/2010;31595;30178;15;46;7;24;;31;31275
16/04/2010;31328;29853;14;45;8;23;;31;30947
19/04/2010;31190;29058;11;42;11;20;;31;30433
20/04/2010;31245;28925;10;41;12;19;;31;30347
21/04/2010;31173;28730;9;40;13;18;;31;30149
22/04/2010;30988;28255;8;39;14;17;;31;29754
23/04/2010;30943;27980;7;38;15;16;;31;29509
26/04/2010;31070;28455;4;35;18;13;;31;29552
27/04/2010;31455;30298;3;34;19;12;;31;30746
28/04/2010;31200;30083;2;33;20;11;;31;30479
29/04/2010;31120;29760;1;32;21;10;;31;30199
30/04/2010;29675;28685;0;31;22;9;;31;28972
04/05/2010;30225;29150;27;57;5;35;;40;30091
05/05/2010;31200;29970;26;56;4;34;;38;31071
06/05/2010;32325;31063;25;55;3;33;;36;32220
07/05/2010;32847;31347;24;54;2;32;;34;32759
10/05/2010;33428;31831;21;51;1;29;;30;33375
11/05/2010;33586;31906;20;50;2;28;;30;33474
12/05/2010;33014;31342;19;49;3;27;;30;32847
13/05/2010;33461;31847;18;48;4;26;;30;33246
14/05/2010;34056;32347;17;47;5;25;;30;33771
17/05/2010;34086;32292;14;44;8;22;;30;33608
18/05/2010;34347;32556;13;43;9;21;;30;33810
19/05/2010;33944;31486;12;42;10;20;;30;33125
20/05/2010;34294;32169;11;41;11;19;;30;33515
21/05/2010;34528;32431;10;40;12;18;;30;33689
24/05/2010;34917;32875;7;37;15;15;;30;33896
25/05/2010;34859;33063;6;36;16;14;;30;33901
26/05/2010;34461;32400;5;35;17;13;;30;33293
27/05/2010;34434;31800;4;34;18;12;;30;32854
28/05/2010;31333;28567;3;33;19;11;;30;29581
01/06/2010;31028;28228;29;60;7;38;;45;30592
02/06/2010;29875;27139;28;59;6;37;;43;29493
03/06/2010;29486;26764;27;58;5;36;;41;29154
04/06/2010;29444;26625;26;57;4;35;;39;29155
07/06/2010;29522;26650;23;54;1;32;;33;29435
08/06/2010;28806;25558;22;53;0;31;;31;28806
09/06/2010;28356;24931;21;52;1;30;;31;28246
10/06/2010;27792;24164;20;51;2;29;;31;27558
11/06/2010;27181;23639;19;50;3;28;;31;26838
14/06/2010;26597;22339;16;47;6;25;;31;25773
15/06/2010;27181;22864;15;46;7;24;;31;26206
16/06/2010;27169;22875;14;45;8;23;;31;26061
17/06/2010;26708;22558;13;44;9;22;;31;25503
18/06/2010;26883;23286;12;43;10;21;;31;25723
21/06/2010;26794;23389;9;40;13;18;;31;25366
22/06/2010;26928;23903;8;39;14;17;;31;25562
23/06/2010;27083;24389;7;38;15;16;;31;25779
24/06/2010;26750;23375;6;37;16;15;;31;25008
25/06/2010;26778;23194;5;36;17;14;;31;24813
28/06/2010;26586;22292;2;33;20;11;;31;23816
29/06/2010;26350;21347;1;32;21;10;;31;22961
30/06/2010;20219;19806;0;31;22;9;;31;19926
01/07/2010;18891;18656;30;61;8;39;;47;18851
02/07/2010;17722;17850;29;60;7;38;;45;17742
05/07/2010;17778;18097;26;57;4;35;;39;17811
06/07/2010;17319;17539;25;56;3;34;;37;17337
07/07/2010;16544;16691;24;55;2;33;;35;16552
08/07/2010;16667;16850;23;54;1;32;;33;16673
09/07/2010;17583;17900;22;53;0;31;;31;17583
12/07/2010;17239;17719;19;50;3;28;;31;17285
13/07/2010;17289;18114;18;49;4;27;;31;17395
14/07/2010;17481;18594;17;48;5;26;;31;17661
15/07/2010;17889;19544;16;47;6;25;;31;18209
16/07/2010;18111;20264;15;46;7;24;;31;18597
19/07/2010;18194;20194;12;43;10;21;;31;18839
20/07/2010;18097;20056;11;42;11;20;;31;18792
21/07/2010;18181;20861;10;41;12;19;;31;19218
22/07/2010;18275;21206;9;40;13;18;;31;19504
23/07/2010;18311;21431;8;39;14;17;;31;19720
26/07/2010;18256;21542;5;36;17;14;;31;20058
27/07/2010;18347;21728;4;35;18;13;;31;20310
28/07/2010;18389;22275;3;34;19;12;;31;20771
29/07/2010;18417;23678;2;33;20;11;;31;21811
30/07/2010;23528;25458;1;32;21;10;;31;24835
02/08/2010;23139;25278;29;59;7;37;;44;23479
03/08/2010;21556;23417;28;58;6;36;;42;21822
04/08/2010;20613;22488;27;57;5;35;;40;20847
05/08/2010;21308;23417;26;56;4;34;;38;21530
06/08/2010;21938;24250;25;55;3;33;;36;22131
09/08/2010;22418;24969;22;52;0;30;;30;22418
10/08/2010;22625;25086;21;51;1;29;;30;22707
11/08/2010;23075;25864;20;50;2;28;;30;23261
12/08/2010;22656;25289;19;49;3;27;;30;22919
13/08/2010;22484;25063;18;48;4;26;;30;22828
16/08/2010;22711;25908;15;45;7;23;;30;23457
17/08/2010;23022;26584;14;44;8;22;;30;23972
18/08/2010;23014;26719;13;43;9;21;;30;24126
19/08/2010;23394;27444;12;42;10;20;;30;24744
20/08/2010;23731;28047;11;41;11;19;;30;25314
23/08/2010;23769;28069;8;38;14;16;;30;25776
24/08/2010;23317;26792;7;37;15;15;;30;25055
25/08/2010;22875;25694;6;36;16;14;;30;24378
26/08/2010;23000;25625;5;35;17;13;;30;24488
27/08/2010;23028;25500;4;34;18;12;;30;24511
31/08/2010;25450;26453;0;30;22;8;;30;26186
01/09/2010;26363;27809;29;60;7;38;;45;26588
02/09/2010;26417;27711;28;59;6;37;;43;26598
03/09/2010;26969;28156;27;58;5;36;;41;27114
06/09/2010;26844;28000;24;55;2;33;;35;26910
07/09/2010;27531;28553;23;54;1;32;;33;27562
08/09/2010;27400;28483;22;53;0;31;;31;27400
09/09/2010;26889;27833;21;52;1;30;;31;26919
10/09/2010;26939;27886;20;51;2;29;;31;27000
13/09/2010;26567;27319;17;48;5;26;;31;26688
14/09/2010;26133;26742;16;47;6;25;;31;26251
15/09/2010;25128;25358;15;46;7;24;;31;25180
16/09/2010;24692;24803;14;45;8;23;;31;24721
17/09/2010;24933;25442;13;44;9;22;;31;25081
20/09/2010;25175;26094;10;41;12;19;;31;25531
21/09/2010;24714;25489;9;40;13;18;;31;25039
22/09/2010;24386;24889;8;39;14;17;;31;24613
23/09/2010;24456;24986;7;38;15;16;;31;24712
24/09/2010;24597;24919;6;37;16;15;;31;24763
27/09/2010;24514;25028;3;34;19;12;;31;24829
28/09/2010;24153;23917;2;33;20;11;;31;24001
29/09/2010;23864;22889;1;32;21;10;;31;23204
30/09/2010;22375;23333;0;31;22;9;;31;23055
01/10/2010;22264;23375;30;60;8;38;;46;22457
04/10/2010;22208;23481;27;57;5;35;;40;22367
05/10/2010;22178;24567;26;56;4;34;;38;22429
06/10/2010;21994;24889;25;55;3;33;;36;22235
07/10/2010;21328;24609;24;54;2;32;;34;21521
08/10/2010;21297;24888;23;53;1;31;;32;21409
11/10/2010;21239;25183;20;50;2;28;;30;21502
12/10/2010;20542;24275;19;49;3;27;;30;20915
13/10/2010;19678;23169;18;48;4;26;;30;20143
14/10/2010;19314;22469;17;47;5;25;;30;19840
15/10/2010;18925;22208;16;46;6;24;;30;19582
18/10/2010;18833;21614;13;43;9;21;;30;19667
19/10/2010;18567;21519;12;42;10;20;;30;19551
20/10/2010;18488;21250;11;41;11;19;;30;19501
21/10/2010;18775;21925;10;40;12;18;;30;20035
22/10/2010;18916;22544;9;39;13;17;;30;20488
25/10/2010;19108;23572;6;36;16;14;;30;21489
26/10/2010;19111;23803;5;35;17;13;;30;21770
27/10/2010;18978;22397;4;34;18;12;;30;21029
28/10/2010;18853;21539;3;33;19;11;;30;20554
29/10/2010;20696;21446;2;32;20;10;;30;21196
01/11/2010;19272;20094;29;60;7;38;;45;19400
02/11/2010;18736;19300;28;59;6;37;;43;18815
03/11/2010;19025;19572;27;58;5;36;;41;19092
04/11/2010;19992;20733;26;57;4;35;;39;20068
05/11/2010;20063;20938;25;56;3;34;;37;20134
08/11/2010;20389;21267;22;53;0;31;;31;20389
09/11/2010;19847;21108;21;52;1;30;;31;19888
10/11/2010;19819;21013;20;51;2;29;;31;19896
11/11/2010;18839;19419;19;50;3;28;;31;18895
12/11/2010;18458;18825;18;49;4;27;;31;18505
15/11/2010;17989;18083;15;46;7;24;;31;18010
16/11/2010;18006;18028;14;45;8;23;;31;18012
17/11/2010;17572;17264;13;44;9;22;;31;17483
18/11/2010;17742;17483;12;43;10;21;;31;17658
19/11/2010;17753;17747;11;42;11;20;;31;17751
22/11/2010;17858;18044;8;39;14;17;;31;17942
23/11/2010;17969;18300;7;38;15;16;;31;18129
24/11/2010;18109;18956;6;37;16;15;;31;18546
25/11/2010;18169;19125;5;36;17;14;;31;18693
26/11/2010;18069;18728;4;35;18;13;;31;18452
29/11/2010;18086;18569;1;32;21;10;;31;18413
30/11/2010;18463;17891;0;31;22;9;;31;18057
01/12/2010;19000;18304;30;61;8;39;;47;18882
02/12/2010;18886;18175;29;60;7;38;;45;18775
03/12/2010;18779;18129;28;59;6;37;;43;18688
06/12/2010;18484;17931;25;56;3;34;;37;18439
07/12/2010;18600;17772;24;55;2;33;;35;18553
08/12/2010;18744;17688;23;54;1;32;;33;18712
09/12/2010;18475;17106;22;53;0;31;;31;18475
10/12/2010;18484;17025;21;52;1;30;;31;18437
13/12/2010;18503;17069;18;49;4;27;;31;18318
14/12/2010;18484;16772;17;48;5;26;;31;18208
15/12/2010;18209;16106;16;47;6;25;;31;17802
16/12/2010;17944;15988;15;46;7;24;;31;17502
17/12/2010;17781;15984;14;45;8;23;;31;17317
20/12/2010;17794;15950;11;42;11;20;;31;17140
21/12/2010;17328;15350;10;41;12;19;;31;16562
22/12/2010;17406;15272;9;40;13;18;;31;16511
23/12/2010;17331;15734;8;39;14;17;;31;16610
24/12/2010;15825;16293;7;38;15;16;;31;16051
29/12/2010;16000;16521;2;33;20;11;;31;16336
30/12/2010;15971;16421;1;32;21;10;;31;16276
31/12/2010;15964;16471;0;31;22;9;;31;16324
04/01/2011;14984;15613;27;55;5;33;;38;15067
05/01/2011;14997;15434;26;54;4;32;;36;15046
06/01/2011;15844;16266;25;53;3;31;;34;15881
07/01/2011;16106;16628;24;52;2;30;;32;16139
10/01/2011;16088;16609;21;49;1;27;;28;16107
11/01/2011;15816;16331;20;48;2;26;;28;15853
12/01/2011;15421;15850;19;47;3;25;;28;15467
13/01/2011;15094;15384;18;46;4;24;;28;15135
14/01/2011;14963;15350;17;45;5;23;;28;15032
17/01/2011;14804;15218;14;42;8;20;;28;14922
18/01/2011;14772;15331;13;41;9;19;;28;14952
19/01/2011;14413;14938;12;40;10;18;;28;14601
20/01/2011;14297;14103;11;39;11;17;;28;14221
21/01/2011;14100;13700;10;38;12;16;;28;13929
24/01/2011;13828;12578;7;35;15;13;;28;13158
25/01/2011;13500;11625;6;34;16;12;;28;12429
26/01/2011;13409;11297;5;33;17;11;;28;12127
27/01/2011;13525;12347;4;32;18;10;;28;12768
28/01/2011;13580;12406;3;31;19;9;;28;12783
31/01/2011;12425;13554;0;28;22;6;;28;13312
01/02/2011;12259;13597;27;58;5;36;;41;12422
02/02/2011;12191;13747;26;57;4;35;;39;12351
03/02/2011;12572;14584;25;56;3;34;;37;12735
04/02/2011;12938;15503;24;55;2;33;;35;13085
07/02/2011;13172;16147;21;52;1;30;;31;13268
08/02/2011;13350;16863;20;51;2;29;;31;13577
09/02/2011;13154;16461;19;50;3;28;;31;13474
10/02/2011;13350;17003;18;49;4;27;;31;13821
11/02/2011;13981;17719;17;48;5;26;;31;14584
14/02/2011;13703;17528;14;45;8;23;;31;14690
15/02/2011;13625;17591;13;44;9;22;;31;14776
16/02/2011;13522;17353;12;43;10;21;;31;14758
17/02/2011;13603;17434;11;42;11;20;;31;14962
18/02/2011;13600;17268;10;41;12;19;;31;15020
21/02/2011;13229;15825;7;38;15;16;;31;14485
22/02/2011;13264;15332;6;37;16;15;;31;14331
23/02/2011;13182;14532;5;36;17;14;;31;13922
24/02/2011;13303;16144;4;35;18;13;;31;14953
25/02/2011;13353;16694;3;34;19;12;;31;15401
28/02/2011;16228;17116;0;31;22;9;;31;16858
01/03/2011;16509;17388;30;60;8;38;;46;16662
02/03/2011;16728;17772;29;59;7;37;;44;16894
03/03/2011;16956;18406;28;58;6;36;;42;17163
04/03/2011;16996;18461;27;57;5;35;;40;17179
07/03/2011;17006;18544;24;54;2;32;;34;17096
08/03/2011;16616;17866;23;53;1;31;;32;16655
09/03/2011;16659;17656;22;52;0;30;;30;16659
10/03/2011;16888;17750;21;51;1;29;;30;16917
11/03/2011;16750;17803;20;50;2;28;;30;16820
14/03/2011;16509;17191;17;47;5;25;;30;16623
15/03/2011;16256;16613;16;46;6;24;;30;16327
16/03/2011;16550;17313;15;45;7;23;;30;16728
17/03/2011;16519;17231;14;44;8;22;;30;16709
18/03/2011;16559;17372;13;43;9;21;;30;16803
21/03/2011;16566;17488;10;40;12;18;;30;16935
22/03/2011;16625;17541;9;39;13;17;;30;17022
23/03/2011;16600;17559;8;38;14;16;;30;17048
24/03/2011;16500;17042;7;37;15;15;;30;16771
25/03/2011;16497;16978;6;36;16;14;;30;16754
28/03/2011;16500;16769;3;33;19;11;;30;16670
29/03/2011;16469;16331;2;32;20;10;;30;16377
30/03/2011;16347;15641;1;31;21;9;;30;15853
31/03/2011;15419;15738;0;30;22;8;;30;15653
01/04/2011;15378;15709;29;60;7;38;;45;15429
04/04/2011;15153;15384;26;57;4;35;;39;15177
05/04/2011;14836;15132;25;56;3;34;;37;14860
06/04/2011;14425;14771;24;55;2;33;;35;14445
07/04/2011;14072;14466;23;54;1;32;;33;14084
08/04/2011;13884;14278;22;53;0;31;;31;13884
11/04/2011;13750;14209;19;50;3;28;;31;13794
12/04/2011;13519;13722;18;49;4;27;;31;13545
13/04/2011;13019;12963;17;48;5;26;;31;13010
14/04/2011;13038;13091;16;47;6;25;;31;13048
15/04/2011;13059;13141;15;46;7;24;;31;13078
18/04/2011;13038;13116;12;43;10;21;;31;13063
19/04/2011;12866;12559;11;42;11;20;;31;12757
20/04/2011;12631;11806;10;41;12;19;;31;12312
21/04/2011;12671;11664;9;40;13;18;;31;12249
26/04/2011;12606;12222;4;35;18;13;;31;12383
27/04/2011;12767;13300;3;34;19;12;;31;13094
28/04/2011;13267;13550;2;33;20;11;;31;13450
03/05/2011;13769;13978;28;58;6;36;;42;13799
04/05/2011;14453;14266;27;57;5;35;;40;14430
05/05/2011;14450;14203;26;56;4;34;;38;14424
06/05/2011;14081;13656;25;55;3;33;;36;14046
09/05/2011;13731;13313;22;52;0;30;;30;13731
10/05/2011;13875;13400;21;51;1;29;;30;13859
11/05/2011;13822;13019;20;50;2;28;;30;13768
12/05/2011;13506;12125;19;49;3;27;;30;13368
13/05/2011;13375;11975;18;48;4;26;;30;13188
16/05/2011;12994;11338;15;45;7;23;;30;12608
17/05/2011;13006;11375;14;44;8;22;;30;12571
18/05/2011;13347;11972;13;43;9;21;;30;12935
19/05/2011;13400;12406;12;42;10;20;;30;13069
20/05/2011;13600;12921;11;41;11;19;;30;13351
23/05/2011;13644;13206;8;38;14;16;;30;13440
24/05/2011;13721;13575;7;37;15;15;;30;13648
25/05/2011;13875;13875;6;36;16;14;;30;13875
26/05/2011;13941;13681;5;35;17;13;;30;13794
27/05/2011;13936;13243;4;34;18;12;;30;13520
31/05/2011;13256;12469;0;30;22;8;;30;12679
01/06/2011;13213;12269;29;60;7;38;;45;13066
02/06/2011;13244;12150;28;59;6;37;;43;13091
03/06/2011;13457;12100;27;58;5;36;;41;13292
06/06/2011;13467;12117;24;55;2;33;;35;13390
07/06/2011;13746;12114;23;54;1;32;;33;13697
08/06/2011;14464;12693;22;53;0;31;;31;14464
09/06/2011;14789;12964;21;52;1;30;;31;14730
10/06/2011;14793;12986;20;51;2;29;;31;14676
13/06/2011;14779;13171;17;48;5;26;;31;14520
14/06/2011;14936;13443;16;47;6;25;;31;14647
15/06/2011;14933;13321;15;46;7;24;;31;14569
16/06/2011;14718;12950;14;45;8;23;;31;14262
17/06/2011;14689;12943;13;44;9;22;;31;14182
20/06/2011;14607;12793;10;41;12;19;;31;13905
21/06/2011;14736;13193;9;40;13;18;;31;14089
22/06/2011;14714;13314;8;39;14;17;;31;14082
23/06/2011;14721;13243;7;38;15;16;;31;14006
24/06/2011;14721;13275;6;37;16;15;;31;13975
27/06/2011;14686;12914;3;34;19;12;;31;13600
28/06/2011;14650;11914;2;33;20;11;;31;12885
29/06/2011;14607;11818;1;32;21;10;;31;12718
30/06/2011;11950;11779;0;31;22;9;;31;11829
01/07/2011;12050;11868;30;61;8;39;;47;12019
04/07/2011;12383;12117;27;58;5;36;;41;12351
05/07/2011;12786;12386;26;57;4;35;;39;12745
06/07/2011;12950;12436;25;56;3;34;;37;12908
07/07/2011;13093;12521;24;55;2;33;;35;13060
08/07/2011;12993;12482;23;54;1;32;;33;12978
11/07/2011;12800;12243;20;51;2;29;;31;12764
12/07/2011;12575;11718;19;50;3;28;;31;12492
13/07/2011;12507;11586;18;49;4;27;;31;12388
14/07/2011;12479;11521;17;48;5;26;;31;12324
15/07/2011;12383;11400;16;47;6;25;;31;12193
18/07/2011;12350;11336;13;44;9;22;;31;12056
19/07/2011;12436;11279;12;43;10;21;;31;12063
20/07/2011;12486;11343;11;42;11;20;;31;12080
21/07/2011;12492;11233;10;41;12;19;;31;12005
22/07/2011;12550;11250;9;40;13;18;;31;12005
25/07/2011;12571;11293;6;37;16;15;;31;11911
26/07/2011;12618;11393;5;36;17;14;;31;11946
27/07/2011;12657;11275;4;35;18;13;;31;11855
28/07/2011;12625;11214;3;34;19;12;;31;11760
29/07/2011;11208;11458;2;33;20;11;;31;11369
01/08/2011;11121;11414;30;60;8;38;;46;11172
02/08/2011;11168;11471;29;59;7;37;;44;11216
03/08/2011;11367;11675;28;58;6;36;;42;11411
04/08/2011;11367;11708;27;57;5;35;;40;11410
05/08/2011;11400;11675;26;56;4;34;;38;11429
08/08/2011;11414;11621;23;53;1;31;;32;11420
09/08/2011;11471;11693;22;52;0;30;;30;11471
10/08/2011;11625;11739;21;51;1;29;;30;11629
11/08/2011;11814;11936;20;50;2;28;;30;11822
12/08/2011;12082;12257;19;49;3;27;;30;12100
15/08/2011;12198;12413;16;46;6;24;;30;12241
16/08/2011;12264;12479;15;45;7;23;;30;12314
17/08/2011;12293;12464;14;44;8;22;;30;12339
18/08/2011;12414;12789;13;43;9;21;;30;12527
19/08/2011;12421;13007;12;42;10;20;;30;12616
22/08/2011;12593;13393;9;39;13;17;;30;12940
23/08/2011;12507;13150;8;38;14;16;;30;12807
24/08/2011;12507;13086;7;37;15;15;;30;12797
25/08/2011;12481;12771;6;36;16;14;;30;12636
26/08/2011;12461;12714;5;35;17;13;;30;12604
30/08/2011;12558;13025;1;31;21;9;;30;12885
31/08/2011;13309;13079;0;30;22;8;;30;13140
01/09/2011;13491;13279;29;60;7;38;;45;13458
02/09/2011;13479;13386;28;59;6;37;;43;13466
05/09/2011;13240;13165;25;56;3;34;;37;13234
06/09/2011;13221;13146;24;55;2;33;;35;13217
07/09/2011;13286;13236;23;54;1;32;;33;13284
08/09/2011;13717;13758;22;53;0;31;;31;13717
09/09/2011;13836;13871;21;52;1;30;;31;13837
12/09/2011;13664;13871;18;49;4;27;;31;13691
13/09/2011;13657;13818;17;48;5;26;;31;13683
14/09/2011;13784;14032;16;47;6;25;;31;13832
15/09/2011;13719;13936;15;46;7;24;;31;13768
16/09/2011;13586;13864;14;45;8;23;;31;13658
19/09/2011;13557;13839;11;42;11;20;;31;13657
20/09/2011;13550;13764;10;41;12;19;;31;13633
21/09/2011;13393;13414;9;40;13;18;;31;13402
22/09/2011;13325;13313;8;39;14;17;;31;13320
23/09/2011;13417;13558;7;38;15;16;;31;13485
26/09/2011;13425;13571;4;35;18;13;;31;13510
27/09/2011;13446;13879;3;34;19;12;;31;13711
28/09/2011;13423;13936;2;33;20;11;;31;13754
29/09/2011;13436;14023;1;32;21;10;;31;13834
30/09/2011;14033;13421;0;31;22;9;;31;13599
03/10/2011;14000;13354;28;58;6;36;;42;13908
04/10/2011;14350;13557;27;57;5;35;;40;14251
05/10/2011;14729;13736;26;56;4;34;;38;14624
06/10/2011;14986;14043;25;55;3;33;;36;14907
07/10/2011;15154;14236;24;54;2;32;;34;15100
10/10/2011;15300;14300;21;51;1;29;;30;15267
11/10/2011;15607;14596;20;50;2;28;;30;15540
12/10/2011;15750;14764;19;49;3;27;;30;15651
13/10/2011;15800;14757;18;48;4;26;;30;15661
14/10/2011;16021;15043;17;47;5;25;;30;15858
17/10/2011;15871;14964;14;44;8;22;;30;15629
18/10/2011;15700;14600;13;43;9;21;;30;15370
19/10/2011;15639;14393;12;42;10;20;;30;15224
20/10/2011;15611;14271;11;41;11;19;;30;15120
21/10/2011;15529;14154;10;40;12;18;;30;14979
24/10/2011;15557;14389;7;37;15;15;;30;14973
25/10/2011;15559;14571;6;36;16;14;;30;15032
26/10/2011;15566;14432;5;35;17;13;;30;14923
27/10/2011;15521;14350;4;34;18;12;;30;14818
28/10/2011;15564;14486;3;33;19;11;;30;14881
31/10/2011;14443;12618;0;30;22;8;;30;13105
01/11/2011;14189;12346;29;60;7;38;;45;13902
02/11/2011;14208;12488;28;59;6;37;;43;13968
03/11/2011;14004;12204;27;58;5;36;;41;13784
04/11/2011;13743;12071;26;57;4;35;;39;13572
07/11/2011;13693;12021;23;54;1;32;;33;13642
08/11/2011;13971;12336;22;53;0;31;;31;13971
09/11/2011;14307;12700;21;52;1;30;;31;14255
10/11/2011;14436;12904;20;51;2;29;;31;14337
11/11/2011;14339;12821;19;50;3;28;;31;14192
14/11/2011;14414;12900;16;47;6;25;;31;14121
15/11/2011;14561;13154;15;46;7;24;;31;14243
16/11/2011;14663;13317;14;45;8;23;;31;14316
17/11/2011;14543;13343;13;44;9;22;;31;14195
18/11/2011;14536;13425;12;43;10;21;;31;14178
21/11/2011;14471;13414;9;40;13;18;;31;14028
22/11/2011;14471;13293;8;39;14;17;;31;13939
23/11/2011;14471;12983;7;38;15;16;;31;13751
24/11/2011;14475;13121;6;37;16;15;;31;13776
25/11/2011;14442;13192;5;36;17;14;;31;13757
28/11/2011;14389;13121;2;33;20;11;;31;13571
29/11/2011;14387;13236;1;32;21;10;;31;13607
30/11/2011;13042;11300;0;31;22;9;;31;11806
01/12/2011;12958;11183;30;61;8;39;;47;12656
02/12/2011;13072;11135;29;60;7;38;;45;12771
05/12/2011;13121;11346;26;57;4;35;;39;12939
06/12/2011;13293;11693;25;56;3;34;;37;13163
07/12/2011;13493;12011;24;55;2;33;;35;13408
08/12/2011;13561;12107;23;54;1;32;;33;13517
09/12/2011;13589;12143;22;53;0;31;;31;13589
12/12/2011;13736;12136;19;50;3;28;;31;13581
13/12/2011;13700;12079;18;49;4;27;;31;13491
14/12/2011;13921;12471;17;48;5;26;;31;13687
15/12/2011;13893;12700;16;47;6;25;;31;13662
16/12/2011;13900;12783;15;46;7;24;;31;13648
19/12/2011;13900;12770;12;43;10;21;;31;13535
20/12/2011;13883;12683;11;42;11;20;;31;13457
21/12/2011;13836;12482;10;41;12;19;;31;13312
22/12/2011;13838;12071;9;40;13;18;;31;13097
23/12/2011;11783;11408;8;39;14;17;;31;11614
28/12/2011;11708;11375;3;34;19;12;;31;11504
29/12/2011;11633;11358;2;33;20;11;;31;11456
30/12/2011;11613;11325;1;32;21;10;;31;11418
03/01/2012;11875;11400;28;57;6;35;;41;11805
04/01/2012;11886;11357;27;56;5;34;;39;11818
05/01/2012;11336;11039;26;55;4;33;;37;11304
06/01/2012;11275;10767;25;54;3;32;;35;11231
09/01/2012;11229;10700;22;51;0;29;;29;11229
10/01/2012;10993;10457;21;50;1;28;;29;10975
11/01/2012;10668;10050;20;49;2;27;;29;10625
12/01/2012;10525;9721;19;48;3;26;;29;10442
13/01/2012;10486;9764;18;47;4;25;;29;10386
16/01/2012;10200;9654;15;44;7;22;;29;10068
17/01/2012;9971;9500;14;43;8;21;;29;9841
18/01/2012;9843;9221;13;42;9;20;;29;9650
19/01/2012;9836;9307;12;41;10;19;;29;9654
20/01/2012;9836;9586;11;40;11;18;;29;9741
23/01/2012;9793;9536;8;37;14;15;;29;9669
24/01/2012;9700;9107;7;36;15;14;;29;9393
25/01/2012;9636;8764;6;35;16;13;;29;9155
26/01/2012;9568;8436;5;34;17;12;;29;8904
27/01/2012;9464;8157;4;33;18;11;;29;8653
30/01/2012;9364;7807;1;30;21;8;;29;8237
31/01/2012;7271;9514;0;29;22;7;;29;8973
01/02/2012;6914;9107;28;59;6;37;;43;7220
02/02/2012;7132;9761;27;58;5;36;;41;7453
03/02/2012;7708;10333;26;57;4;35;;39;7977
06/02/2012;7314;10100;23;54;1;32;;33;7398
07/02/2012;7439;10421;22;53;0;31;;31;7439
08/02/2012;8108;11429;21;52;1;30;;31;8215
09/02/2012;8571;11861;20;51;2;29;;31;8783
10/02/2012;8675;12275;19;50;3;28;;31;9023
13/02/2012;8000;11000;16;47;6;25;;31;8581
14/02/2012;7646;10471;15;46;7;24;;31;8284
15/02/2012;7464;9907;14;45;8;23;;31;8094
16/02/2012;7467;10125;13;44;9;22;;31;8239
17/02/2012;7271;9882;12;43;10;21;;31;8113
20/02/2012;7096;9408;9;40;13;18;;31;8066
21/02/2012;7014;9086;8;39;14;17;;31;7950
22/02/2012;6967;8796;7;38;15;16;;31;7852
23/02/2012;6936;9021;6;37;16;15;;31;8012
24/02/2012;6924;9164;5;36;17;14;;31;8152
27/02/2012;6900;9129;2;33;20;11;;31;8338
28/02/2012;6864;8593;1;32;21;10;;31;8035
29/02/2012;8432;10443;0;31;22;9;;31;9859
01/03/2012;8711;10700;30;60;8;38;;46;9057
02/03/2012;8521;10618;29;59;7;37;;44;8855
05/03/2012;8311;10439;26;56;4;34;;38;8535
06/03/2012;7814;9979;25;55;3;33;;36;7994
07/03/2012;8021;10361;24;54;2;32;;34;8159
08/03/2012;8157;10575;23;53;1;31;;32;8233
09/03/2012;8158;10667;22;52;0;30;;30;8158
12/03/2012;7993;10304;19;49;3;27;;30;8224
13/03/2012;7829;10064;18;48;4;26;;30;8127
14/03/2012;7757;9800;17;47;5;25;;30;8098
15/03/2012;7900;10200;16;46;6;24;;30;8360
16/03/2012;7818;10014;15;45;7;23;;30;8330
19/03/2012;7786;9943;12;42;10;20;;30;8505
20/03/2012;7786;9957;11;41;11;19;;30;8582
21/03/2012;7811;9932;10;40;12;18;;30;8659
22/03/2012;7771;9893;9;39;13;17;;30;8691
23/03/2012;7708;9567;8;38;14;16;;30;8576
26/03/2012;7629;9379;5;35;17;13;;30;8621
27/03/2012;7607;9057;4;34;18;12;;30;8477
28/03/2012;7643;9514;3;33;19;11;;30;8828
29/03/2012;7664;9650;2;32;20;10;;30;8988
30/03/2012;9667;9917;1;31;21;9;;30;9842
02/04/2012;9325;9600;28;59;6;37;;43;9363
03/04/2012;9121;9432;27;58;5;36;;41;9159
04/04/2012;9136;9532;26;57;4;35;;39;9177
05/04/2012;9171;9693;25;56;3;34;;37;9213
10/04/2012;9164;9961;20;51;2;29;;31;9215
11/04/2012;9211;10504;19;50;3;28;;31;9336
12/04/2012;9246;10504;18;49;4;27;;31;9408
13/04/2012;9371;10746;17;48;5;26;;31;9593
16/04/2012;9529;10757;14;45;8;23;;31;9846
17/04/2012;9714;11275;13;44;9;22;;31;10167
18/04/2012;9796;11564;12;43;10;21;;31;10366
19/04/2012;10107;11871;11;42;11;20;;31;10733
20/04/2012;10325;12507;10;41;12;19;;31;11170
23/04/2012;10389;12350;7;38;15;16;;31;11338
24/04/2012;10543;12550;6;37;16;15;;31;11579
25/04/2012;10593;13143;5;36;17;14;;31;11991
26/04/2012;10493;12621;4;35;18;13;;31;11729
27/04/2012;10496;12133;3;34;19;12;;31;11499
30/04/2012;12007;9936;0;31;22;9;;31;10537
01/05/2012;11975;9967;30;60;8;38;;46;11626
02/05/2012;12614;10521;29;59;7;37;;44;12281
03/05/2012;11707;9829;28;58;6;36;;42;11439
04/05/2012;11321;9575;27;57;5;35;;40;11103
08/05/2012;10864;9279;23;53;1;31;;32;10814
09/05/2012;11029;9486;22;52;0;30;;30;11029
10/05/2012;10929;9350;21;51;1;29;;30;10876
11/05/2012;11071;9693;20;50;2;28;;30;10979
14/05/2012;10907;9621;17;47;5;25;;30;10693
15/05/2012;10857;9557;16;46;6;24;;30;10597
16/05/2012;10807;9521;15;45;7;23;;30;10507
17/05/2012;10793;9461;14;44;8;22;;30;10438
18/05/2012;10907;9664;13;43;9;21;;30;10534
21/05/2012;10800;9471;10;40;12;18;;30;10268
22/05/2012;10579;8900;9;39;13;17;;30;9851
23/05/2012;10432;8136;8;38;14;16;;30;9361
24/05/2012;10308;7808;7;37;15;15;;30;9058
25/05/2012;10243;7600;6;36;16;14;;30;8833
28/05/2012;10242;7683;3;33;19;11;;30;8621
29/05/2012;10236;7436;2;32;20;10;;30;8369
30/05/2012;10186;6775;1;31;21;9;;30;7798
31/05/2012;7021;7346;0;30;22;8;;30;7259
01/06/2012;7000;7275;29;60;7;38;;45;7043
06/06/2012;7243;7582;24;55;2;33;;35;7262
07/06/2012;7893;8029;23;54;1;32;;33;7897
08/06/2012;7938;8021;22;53;0;31;;31;7938
11/06/2012;8175;8354;19;50;3;28;;31;8192
12/06/2012;8286;8382;18;49;4;27;;31;8298
13/06/2012;8321;8364;17;48;5;26;;31;8328
14/06/2012;8107;8057;16;47;6;25;;31;8097
15/06/2012;8100;8050;15;46;7;24;;31;8089
18/06/2012;8086;8000;12;43;10;21;;31;8058
19/06/2012;8068;8029;11;42;11;20;;31;8054
20/06/2012;8036;7904;10;41;12;19;;31;7985
21/06/2012;7950;7557;9;40;13;18;;31;7785
22/06/2012;7921;7421;8;39;14;17;;31;7695
25/06/2012;7893;7221;5;36;17;14;;31;7524
26/06/2012;7909;7418;4;35;18;13;;31;7624
27/06/2012;7916;7333;3;34;19;12;;31;7559
28/06/2012;7924;7339;2;33;20;11;;31;7547
29/06/2012;7510;7480;1;32;21;10;;31;7490
02/07/2012;7750;7857;29;60;7;38;;45;7767
03/07/2012;8217;8183;28;59;6;37;;43;8212
04/07/2012;8433;8246;27;58;5;36;;41;8410
05/07/2012;8836;8400;26;57;4;35;;39;8791
06/07/2012;9071;8500;25;56;3;34;;37;9025
09/07/2012;8850;8418;22;53;0;31;;31;8850
10/07/2012;8514;8182;21;52;1;30;;31;8503
11/07/2012;8746;8393;20;51;2;29;;31;8723
12/07/2012;8679;8261;19;50;3;28;;31;8639
13/07/2012;8886;8357;18;49;4;27;;31;8818
16/07/2012;9171;8479;15;46;7;24;;31;9015
17/07/2012;9064;8232;14;45;8;23;;31;8849
18/07/2012;8900;7814;13;44;9;22;;31;8585
19/07/2012;8900;7779;12;43;10;21;;31;8538
20/07/2012;8929;7832;11;42;11;20;;31;8540
23/07/2012;8907;7714;8;39;14;17;;31;8368
24/07/2012;8868;7529;7;38;15;16;;31;8220
25/07/2012;8850;7439;6;37;16;15;;31;8122
26/07/2012;8857;7443;5;36;17;14;;31;8082
27/07/2012;8842;7483;4;35;18;13;;31;8053
30/07/2012;8832;7418;1;32;21;10;;31;7874
31/07/2012;7193;7636;0;31;22;9;;31;7507
01/08/2012;7000;7386;30;60;8;38;;46;7067
02/08/2012;6746;7093;29;59;7;37;;44;6801
03/08/2012;6855;7225;28;58;6;36;;42;6908
06/08/2012;6879;7336;25;55;3;33;;36;6917
07/08/2012;6854;7296;24;54;2;32;;34;6880
08/08/2012;6771;7286;23;53;1;31;;32;6787
09/08/2012;6886;7464;22;52;0;30;;30;6886
10/08/2012;6904;7550;21;51;1;29;;30;6926
13/08/2012;6871;7479;18;48;4;26;;30;6952
14/08/2012;6914;7671;17;47;5;25;;30;7040
15/08/2012;6936;7679;16;46;6;24;;30;7085
16/08/2012;6821;7704;15;45;7;23;;30;7027
17/08/2012;6879;7950;14;44;8;22;;30;7165
20/08/2012;6879;8143;11;41;11;19;;30;7342
21/08/2012;6879;7907;10;40;12;18;;30;7290
22/08/2012;6821;7746;9;39;13;17;;30;7222
23/08/2012;6754;7450;8;38;14;16;;30;7079
24/08/2012;6738;7288;7;37;15;15;;30;7013
28/08/2012;6689;7043;3;33;19;11;;30;6913
29/08/2012;6681;6736;2;32;20;10;;30;6718
30/08/2012;6605;6318;1;31;21;9;;30;6404
31/08/2012;6233;7408;0;30;22;8;;30;7095
03/09/2012;6155;7480;27;58;5;36;;41;6317
04/09/2012;5525;7050;26;57;4;35;;39;5681
05/09/2012;5014;6236;25;56;3;34;;37;5113
06/09/2012;4883;6083;24;55;2;33;;35;4952
07/09/2012;4957;6207;23;54;1;32;;33;4995
10/09/2012;4957;6343;20;51;2;29;;31;5046
11/09/2012;4836;5993;19;50;3;28;;31;4948
12/09/2012;4525;5632;18;49;4;27;;31;4668
13/09/2012;4350;5658;17;48;5;26;;31;4561
14/09/2012;4296;5717;16;47;6;25;;31;4571
17/09/2012;4207;5579;13;44;9;22;;31;4605
18/09/2012;4250;5971;12;43;10;21;;31;4805
19/09/2012;4275;5850;11;42;11;20;;31;4834
20/09/2012;4229;5864;10;41;12;19;;31;4862
21/09/2012;4200;5642;9;40;13;18;;31;4805
24/09/2012;4129;5242;6;37;16;15;;31;4703
25/09/2012;4118;5193;5;36;17;14;;31;4708
26/09/2012;4107;4757;4;35;18;13;;31;4484
27/09/2012;4142;5108;3;34;19;12;;31;4734
28/09/2012;5061;6657;2;33;20;11;;31;6091
01/10/2012;5257;7221;30;60;8;38;;46;5599
02/10/2012;5225;7296;29;59;7;37;;44;5554
03/10/2012;5521;7429;28;58;6;36;;42;5794
04/10/2012;6043;8043;27;57;5;35;;40;6293
05/10/2012;6221;8221;26;56;4;34;;38;6432
08/10/2012;6093;7707;23;53;1;31;;32;6143
09/10/2012;6336;8050;22;52;0;30;;30;6336
10/10/2012;6508;8100;21;51;1;29;;30;6561
11/10/2012;6611;7971;20;50;2;28;;30;6702
12/10/2012;6393;7593;19;49;3;27;;30;6513
15/10/2012;6407;7536;16;46;6;24;;30;6633
16/10/2012;6621;8029;15;45;7;23;;30;6950
17/10/2012;6164;7264;14;44;8;22;;30;6457
18/10/2012;6064;7064;13;43;9;21;;30;6364
19/10/2012;6121;7114;12;42;10;20;;30;6452
22/10/2012;6183;7300;9;39;13;17;;30;6667
23/10/2012;6175;7693;8;38;14;16;;30;6883
24/10/2012;6093;7071;7;37;15;15;;30;6582
25/10/2012;6036;7114;6;36;16;14;;30;6611
26/10/2012;6064;7014;5;35;17;13;;30;6602
29/10/2012;6029;6825;2;32;20;10;;30;6560
30/10/2012;6029;6854;1;31;21;9;;30;6607
31/10/2012;6750;6758;0;30;22;8;;30;6756
01/11/2012;6350;6468;29;60;7;38;;45;6368
02/11/2012;6444;6613;28;59;6;37;;43;6468
05/11/2012;6620;6810;25;56;3;34;;37;6635
06/11/2012;6311;6550;24;55;2;33;;35;6325
07/11/2012;6286;6532;23;54;1;32;;33;6293
08/11/2012;6479;6821;22;53;0;31;;31;6479
09/11/2012;6646;7104;21;52;1;30;;31;6661
12/11/2012;6396;7229;18;49;4;27;;31;6503
13/11/2012;6579;7525;17;48;5;26;;31;6732
14/11/2012;6550;7532;16;47;6;25;;31;6740
15/11/2012;6646;7629;15;46;7;24;;31;6868
16/11/2012;6736;7750;14;45;8;23;;31;6998
19/11/2012;6907;7943;11;42;11;20;;31;7275
20/11/2012;6779;7864;10;41;12;19;;31;7199
21/11/2012;6864;8121;9;40;13;18;;31;7391
22/11/2012;6970;8270;8;39;14;17;;31;7557
23/11/2012;6975;8225;7;38;15;16;;31;7580
26/11/2012;6962;7886;4;35;18;13;;31;7499
27/11/2012;6867;7583;3;34;19;12;;31;7306
28/11/2012;6888;7400;2;33;20;11;;31;7218
29/11/2012;6876;7364;1;32;21;10;;31;7207
30/11/2012;7367;5850;0;31;22;9;;31;6290
03/12/2012;7304;5808;28;59;6;37;;43;7095
04/12/2012;7307;5800;27;58;5;36;;41;7123
05/12/2012;7021;5596;26;57;4;35;;39;6875
06/12/2012;7058;5517;25;56;3;34;;37;6933
07/12/2012;7108;5488;24;55;2;33;;35;7015
10/12/2012;7108;5504;21;52;1;30;;31;7056
11/12/2012;7014;5393;20;51;2;29;;31;6909
12/12/2012;7000;5343;19;50;3;28;;31;6840
13/12/2012;7007;5356;18;49;4;27;;31;6794
14/12/2012;7007;5386;17;48;5;26;;31;6746
17/12/2012;6971;5543;14;45;8;23;;31;6602
18/12/2012;6913;5417;13;44;9;22;;31;6479
19/12/2012;6850;5071;12;43;10;21;;31;6276
20/12/2012;6850;5057;11;42;11;20;;31;6214
21/12/2012;6848;5144;10;41;12;19;;31;6188
24/12/2012;5238;5575;7;38;15;16;;31;5401
27/12/2012;5319;5575;4;35;18;13;;31;5468
28/12/2012;5344;5575;3;34;19;12;;31;5486
31/12/2012;5344;5575;0;31;22;9;;31;5508
02/01/2013;5407;5607;29;57;7;35;;42;5440
03/01/2013;5479;5764;28;56;6;34;;40;5522
04/01/2013;5493;5871;27;55;5;33;;38;5543
07/01/2013;5700;6200;24;52;2;30;;32;5731
08/01/2013;5814;6529;23;51;1;29;;30;5838
09/01/2013;5957;6607;22;50;0;28;;28;5957
10/01/2013;6014;6729;21;49;1;27;;28;6040
11/01/2013;5864;6571;20;48;2;26;;28;5915
14/01/2013;5629;6300;17;45;5;23;;28;5749
15/01/2013;5771;6643;16;44;6;22;;28;5958
16/01/2013;5686;6479;15;43;7;21;;28;5884
17/01/2013;5633;6375;14;42;8;20;;28;5845
18/01/2013;5575;6392;13;41;9;19;;28;5838
21/01/2013;5595;6550;10;38;12;16;;28;6004
22/01/2013;5592;6442;9;37;13;15;;28;5987
23/01/2013;5604;6389;8;36;14;14;;28;5997
24/01/2013;5625;6354;7;35;15;13;;28;6016
25/01/2013;5650;6207;6;34;16;12;;28;5968
28/01/2013;5658;6200;3;31;19;9;;28;6026
29/01/2013;5618;5821;2;30;20;8;;28;5763
30/01/2013;5619;5643;1;29;21;7;;28;5637
31/01/2013;5632;7207;0;28;22;6;;28;6870
01/02/2013;5633;7238;27;58;5;36;;41;5829
04/02/2013;5654;7282;24;55;2;33;;35;5747
05/02/2013;5600;7293;23;54;1;32;;33;5651
06/02/2013;5614;7275;22;53;0;31;;31;5614
07/02/2013;5846;7679;21;52;1;30;;31;5905
08/02/2013;6018;7921;20;51;2;29;;31;6141
11/02/2013;6036;8011;17;48;5;26;;31;6355
12/02/2013;5943;7836;16;47;6;25;;31;6309
13/02/2013;6186;8196;15;46;7;24;;31;6640
14/02/2013;6400;8393;14;45;8;23;;31;6914
15/02/2013;6439;8436;13;44;9;22;;31;7019
18/02/2013;6492;8625;10;41;12;19;;31;7318
19/02/2013;6379;8204;9;40;13;18;;31;7144
20/02/2013;6350;8142;8;39;14;17;;31;7159
21/02/2013;6386;8493;7;38;15;16;;31;7406
22/02/2013;6414;8657;6;37;16;15;;31;7572
25/02/2013;6407;8714;3;34;19;12;;31;7821
26/02/2013;6375;8721;2;33;20;11;;31;7889
27/02/2013;6414;8919;1;32;21;10;;31;8111
28/02/2013;9225;9875;0;31;22;9;;31;9686
01/03/2013;9600;10114;30;60;8;38;;46;9689
04/03/2013;9833;10304;27;57;5;35;;40;9892
05/03/2013;9636;10200;26;56;4;34;;38;9695
06/03/2013;9425;10021;25;55;3;33;;36;9475
07/03/2013;9182;9879;24;54;2;32;;34;9223
08/03/2013;9329;9979;23;53;1;31;;32;9349
11/03/2013;9292;9950;20;50;2;28;;30;9336
12/03/2013;9407;10179;19;49;3;27;;30;9484
13/03/2013;9479;10386;18;48;4;26;;30;9600
14/03/2013;9386;10293;17;47;5;25;;30;9537
15/03/2013;9442;10471;16;46;6;24;;30;9648
18/03/2013;9443;10550;13;43;9;21;;30;9775
19/03/2013;9350;10329;12;42;10;20;;30;9676
20/03/2013;9275;10086;11;41;11;19;;30;9572
21/03/2013;9304;10167;10;40;12;18;;30;9649
22/03/2013;9317;10150;9;39;13;17;;30;9678
25/03/2013;9279;9850;6;36;16;14;;30;9584
26/03/2013;9232;9679;5;35;17;13;;30;9485
27/03/2013;9192;9408;4;34;18;12;;30;9322
28/03/2013;9339;9171;3;33;19;11;;30;9233
02/04/2013;9150;8993;28;59;6;37;;43;9128
03/04/2013;8807;8782;27;58;5;36;;41;8804
04/04/2013;8736;8750;26;57;4;35;;39;8737
05/04/2013;8964;9029;25;56;3;34;;37;8969
08/04/2013;9057;9286;22;53;0;31;;31;9057
09/04/2013;8993;9207;21;52;1;30;;31;9000
10/04/2013;9154;9450;20;51;2;29;;31;9173
11/04/2013;9171;9514;19;50;3;28;;31;9204
12/04/2013;9213;9617;18;49;4;27;;31;9265
15/04/2013;9214;9600;15;46;7;24;;31;9301
16/04/2013;9257;9614;14;45;8;23;;31;9349
17/04/2013;9354;9804;13;44;9;22;;31;9485
18/04/2013;9275;9396;12;43;10;21;;31;9314
19/04/2013;9300;9436;11;42;11;20;;31;9348
22/04/2013;9225;9164;8;39;14;17;;31;9197
23/04/2013;9100;8500;7;38;15;16;;31;8810
24/04/2013;9046;8188;6;37;16;15;;31;8603
25/04/2013;8930;7930;5;36;17;14;;31;8382
26/04/2013;8910;7760;4;35;18;13;;31;8242
29/04/2013;8942;7850;1;32;21;10;;31;8202
30/04/2013;7696;7286;0;31;22;9;;31;7405
01/05/2013;7671;7292;30;60;8;38;;46;7605
02/05/2013;7979;7493;29;59;7;37;;44;7902
03/05/2013;8117;7567;28;58;6;36;;42;8038
07/05/2013;7968;7407;24;54;2;32;;34;7935
08/05/2013;7700;7242;23;53;1;31;;32;7686
09/05/2013;7739;7250;22;52;0;30;;30;7739
10/05/2013;7733;7208;21;51;1;29;;30;7716
13/05/2013;7739;7189;18;48;4;26;;30;7666
14/05/2013;7517;6783;17;47;5;25;;30;7395
15/05/2013;7379;6529;16;46;6;24;;30;7209
16/05/2013;7339;6325;15;45;7;23;;30;7102
17/05/2013;7332;6264;14;44;8;22;;30;7047
20/05/2013;7342;6354;11;41;11;19;;30;6980
21/05/2013;7367;6317;10;40;12;18;;30;6947
22/05/2013;7370;6260;9;39;13;17;;30;6889
23/05/2013;7350;6189;8;38;14;16;;30;6808
24/05/2013;7371;6161;7;37;15;15;;30;6766
28/05/2013;7336;5979;3;33;19;11;;30;6477
29/05/2013;7364;6007;2;32;20;10;;30;6459
30/05/2013;7358;5888;1;31;21;9;;30;6329
31/05/2013;5964;5821;0;30;22;8;;30;5859
03/06/2013;5925;5793;27;58;5;36;;41;5909
04/06/2013;5925;5779;26;57;4;35;;39;5910
05/06/2013;5871;5671;25;56;3;34;;37;5855
06/06/2013;5900;5765;24;55;2;33;;35;5892
07/06/2013;6080;5950;23;54;1;32;;33;6076
10/06/2013;6192;6092;20;51;2;29;;31;6186
11/06/2013;6304;6207;19;50;3;28;;31;6295
12/06/2013;6454;6421;18;49;4;27;;31;6450
13/06/2013;6439;6357;17;48;5;26;;31;6426
14/06/2013;6621;6475;16;47;6;25;;31;6593
17/06/2013;6679;6550;13;44;9;22;;31;6642
18/06/2013;6718;6571;12;43;10;21;;31;6671
19/06/2013;6775;6668;11;42;11;20;;31;6737
20/06/2013;6804;6688;10;41;12;19;;31;6759
21/06/2013;6807;6618;9;40;13;18;;31;6728
24/06/2013;6825;6654;6;37;16;15;;31;6737
25/06/2013;6896;7036;5;36;17;14;;31;6973
26/06/2013;6950;7436;4;35;18;13;;31;7232
27/06/2013;6907;7321;3;34;19;12;;31;7161
28/06/2013;7671;7036;2;33;20;11;;31;7261
01/07/2013;7692;7067;30;61;8;39;;47;7586
02/07/2013;7286;6661;29;60;7;38;;45;7189
03/07/2013;7358;6804;28;59;6;37;;43;7281
04/07/2013;7379;6821;27;58;5;36;;41;7311
05/07/2013;7540;6865;26;57;4;35;;39;7471
08/07/2013;7636;6936;23;54;1;32;;33;7615
09/07/2013;7693;6993;22;53;0;31;;31;7693
10/07/2013;7925;7292;21;52;1;30;;31;7905
11/07/2013;8596;7993;20;51;2;29;;31;8557
12/07/2013;8879;8261;19;50;3;28;;31;8819
15/07/2013;8779;8129;16;47;6;25;;31;8653
16/07/2013;8671;7958;15;46;7;24;;31;8510
17/07/2013;8739;8121;14;45;8;23;;31;8580
18/07/2013;8675;7975;13;44;9;22;;31;8472
19/07/2013;8695;8100;12;43;10;21;;31;8503
22/07/2013;8679;8125;9;40;13;18;;31;8447
23/07/2013;8621;7800;8;39;14;17;;31;8250
24/07/2013;8607;7721;7;38;15;16;;31;8178
25/07/2013;8604;7583;6;37;16;15;;31;8077
26/07/2013;8638;7613;5;36;17;14;;31;8076
29/07/2013;8619;7779;2;33;20;11;;31;8077
30/07/2013;8600;7739;1;32;21;10;;31;8017
31/07/2013;7711;7846;0;31;22;9;;31;7807
01/08/2013;7829;8007;30;60;8;38;;46;7860
02/08/2013;7971;8357;29;59;7;37;;44;8032
05/08/2013;7907;8336;26;56;4;34;;38;7952
06/08/2013;7664;8171;25;55;3;33;;36;7706
07/08/2013;7496;8043;24;54;2;32;;34;7528
08/08/2013;7521;8121;23;53;1;31;;32;7540
09/08/2013;7525;8360;22;52;0;30;;30;7525
12/08/2013;7607;8600;19;49;3;27;;30;7706
13/08/2013;7664;8721;18;48;4;26;;30;7805
14/08/2013;7743;8829;17;47;5;25;;30;7924
15/08/2013;7779;8863;16;46;6;24;;30;7996
16/08/2013;7750;8738;15;45;7;23;;30;7981
19/08/2013;7650;8586;12;42;10;20;;30;7962
20/08/2013;7629;8614;11;41;11;19;;30;7990
21/08/2013;7596;8508;10;40;12;18;;30;7961
22/08/2013;7558;8542;9;39;13;17;;30;7984
23/08/2013;7593;8800;8;38;14;16;;30;8156
27/08/2013;7602;8771;4;34;18;12;;30;8303
28/08/2013;7503;8342;3;33;19;11;;30;8034
29/08/2013;7531;8518;2;32;20;10;;30;8189
30/08/2013;8450;10092;1;31;21;9;;30;9599
02/09/2013;8300;10050;28;59;6;37;;43;8544
03/09/2013;8457;10314;27;58;5;36;;41;8683
04/09/2013;8563;10617;26;57;4;35;;39;8774
05/09/2013;8758;11029;25;56;3;34;;37;8942
06/09/2013;9690;12640;24;55;2;33;;35;9859
09/09/2013;10050;13114;21;52;1;30;;31;10149
10/09/2013;9808;12800;20;51;2;29;;31;10001
11/09/2013;9729;12464;19;50;3;28;;31;9994
12/09/2013;9671;12421;18;49;4;27;;31;10026
13/09/2013;9971;13200;17;48;5;26;;31;10492
16/09/2013;10036;13693;14;45;8;23;;31;10980
17/09/2013;10264;14164;13;44;9;22;;31;11396
18/09/2013;10160;14020;12;43;10;21;;31;11405
19/09/2013;10270;14540;11;42;11;20;;31;11785
20/09/2013;10320;15400;10;41;12;19;;31;12286
23/09/2013;10483;16450;7;38;15;16;;31;13370
24/09/2013;10525;16871;6;37;16;15;;31;13800
25/09/2013;10586;16971;5;36;17;14;;31;14087
26/09/2013;10397;15728;4;35;18;13;;31;13492
27/09/2013;10457;14600;3;34;19;12;;31;12996
30/09/2013;15092;14629;0;31;22;9;;31;14763
01/10/2013;15742;15325;30;60;8;38;;46;15669
02/10/2013;16592;16267;29;59;7;37;;44;16540
03/10/2013;16763;16588;28;58;6;36;;42;16738
04/10/2013;16960;17060;27;57;5;35;;40;16973
07/10/2013;16970;16865;24;54;2;32;;34;16964
08/10/2013;16367;16325;23;53;1;31;;32;16366
09/10/2013;15900;15970;22;52;0;30;;30;15900
10/10/2013;15421;15358;21;51;1;29;;30;15419
11/10/2013;15838;15696;20;50;2;28;;30;15829
14/10/2013;15613;15292;17;47;5;25;;30;15560
15/10/2013;16279;15963;16;46;6;24;;30;16216
16/10/2013;16192;15992;15;45;7;23;;30;16145
17/10/2013;15696;15317;14;44;8;22;;30;15595
18/10/2013;15571;14833;13;43;9;21;;30;15350
21/10/2013;15546;14133;10;40;12;18;;30;14981
22/10/2013;15667;13921;9;39;13;17;;30;14910
23/10/2013;15583;13183;8;38;14;16;;30;14463
24/10/2013;15596;13021;7;37;15;15;;30;14309
25/10/2013;15608;13363;6;36;16;14;;30;14411
28/10/2013;15440;12760;3;33;19;11;;30;13743
29/10/2013;15375;12100;2;32;20;10;;30;13192
30/10/2013;15485;12280;1;31;21;9;;30;13242
31/10/2013;12658;10496;0;30;22;8;;30;11073
01/11/2013;12733;10688;29;60;7;38;;45;12415
04/11/2013;13238;11271;26;57;4;35;;39;13036
05/11/2013;13267;11221;25;56;3;34;;37;13101
06/11/2013;12638;10608;24;55;2;33;;35;12522
07/11/2013;12630;10705;23;54;1;32;;33;12572
08/11/2013;12579;10896;22;53;0;31;;31;12579
11/11/2013;12054;10542;19;50;3;28;;31;11908
12/11/2013;11840;10480;18;49;4;27;;31;11665
13/11/2013;11621;10004;17;48;5;26;;31;11360
14/11/2013;11208;9571;16;47;6;25;;31;10891
15/11/2013;11217;9646;15;46;7;24;;31;10862
18/11/2013;11233;9713;12;43;10;21;;31;10743
19/11/2013;11496;10021;11;42;11;20;;31;10973
20/11/2013;11729;10717;10;41;12;19;;31;11337
21/11/2013;11621;10600;9;40;13;18;;31;11193
22/11/2013;11842;11196;8;39;14;17;;31;11550
25/11/2013;11929;11850;5;36;17;14;;31;11886
26/11/2013;11925;11863;4;35;18;13;;31;11889
27/11/2013;11967;12954;3;34;19;12;;31;12572
28/11/2013;12090;13090;2;33;20;11;;31;12735
29/11/2013;13225;11213;1;32;21;10;;31;11862
02/12/2013;13504;11354;29;60;7;38;;45;13170
03/12/2013;13721;11404;28;59;6;37;;43;13398
04/12/2013;14146;11625;27;58;5;36;;41;13839
05/12/2013;14970;12140;26;57;4;35;;39;14680
06/12/2013;15663;12513;25;56;3;34;;37;15408
09/12/2013;15575;12954;22;53;0;31;;31;15575
10/12/2013;15942;13167;21;52;1;30;;31;15852
11/12/2013;15830;12940;20;51;2;29;;31;15644
12/12/2013;15558;12579;19;50;3;28;;31;15270
13/12/2013;15535;12470;18;49;4;27;;31;15140
16/12/2013;15413;11583;15;46;7;24;;31;14548
17/12/2013;15483;12083;14;45;8;23;;31;14606
18/12/2013;15450;12270;13;44;9;22;;31;14527
19/12/2013;15450;12821;12;43;10;21;;31;14602
20/12/2013;15430;14260;11;42;11;20;;31;15015
23/12/2013;15346;14175;8;39;14;17;;31;14817
24/12/2013;14046;12758;7;38;15;16;;31;13423
27/12/2013;13920;12685;4;35;18;13;;31;13203
30/12/2013;13255;12230;1;32;21;10;;31;12561
31/12/2013;13305;12400;0;31;22;9;;31;12663
02/01/2014;13175;12346;29;57;7;35;;42;13037
03/01/2014;12495;11945;28;56;6;34;;40;12413
06/01/2014;12415;11945;25;53;3;31;;34;12374
07/01/2014;12560;12060;24;52;2;30;;32;12529
08/01/2014;12617;12096;23;51;1;29;;30;12600
09/01/2014;12688;12396;22;50;0;28;;28;12688
10/01/2014;12785;12605;21;49;1;27;;28;12779
13/01/2014;12854;12933;18;46;4;24;;28;12865
14/01/2014;12883;13454;17;45;5;23;;28;12985
15/01/2014;12833;13533;16;44;6;22;;28;12983
16/01/2014;12920;13920;15;43;7;21;;28;13170
17/01/2014;12765;13400;14;42;8;20;;28;12946
20/01/2014;12650;12610;11;39;11;17;;28;12634
21/01/2014;12520;12085;10;38;12;16;;28;12334
22/01/2014;12483;11867;9;37;13;15;;28;12197
23/01/2014;12313;11688;8;36;14;14;;28;12001
24/01/2014;12400;11763;7;35;15;13;;28;12059
27/01/2014;12346;11633;4;32;18;10;;28;11888
28/01/2014;12304;11500;3;31;19;9;;28;11758
29/01/2014;12296;11700;2;30;20;8;;28;11870
30/01/2014;12263;11275;1;29;21;7;;28;11522
31/01/2014;11254;13892;0;28;22;6;;28;13327
03/02/2014;11070;13600;25;56;3;34;;37;11275
04/02/2014;10854;13425;24;55;2;33;;35;11001
05/02/2014;11096;13883;23;54;1;32;;33;11180
06/02/2014;11100;13763;22;53;0;31;;31;11100
07/02/2014;10933;13592;21;52;1;30;;31;11019
10/02/2014;10988;13829;18;49;4;27;;31;11355
11/02/2014;10992;13700;17;48;5;26;;31;11429
12/02/2014;11042;13321;16;47;6;25;;31;11483
13/02/2014;10820;12890;15;46;7;24;;31;11287
14/02/2014;10845;13015;14;45;8;23;;31;11405
17/02/2014;10705;12570;11;42;11;20;;31;11367
18/02/2014;10717;12775;10;41;12;19;;31;11514
19/02/2014;10642;12708;9;40;13;18;;31;11508
20/02/2014;10480;12510;8;39;14;17;;31;11397
21/02/2014;10340;12430;7;38;15;16;;31;11351
24/02/2014;10225;11500;4;35;18;13;;31;10965
25/02/2014;10138;11100;3;34;19;12;;31;10728
26/02/2014;10142;10996;2;33;20;11;;31;10693
27/02/2014;10150;10888;1;32;21;10;;31;10650
28/02/2014;10610;13290;0;31;22;9;;31;12512
03/03/2014;10550;13213;28;58;6;36;;42;10930
04/03/2014;10417;13000;27;57;5;35;;40;10740
05/03/2014;10175;13304;26;56;4;34;;38;10504
06/03/2014;10492;13650;25;55;3;33;;36;10755
07/03/2014;10788;14467;24;54;2;32;;34;11004
10/03/2014;10371;13713;21;51;1;29;;30;10482
11/03/2014;9800;12935;20;50;2;28;;30;10009
12/03/2014;9650;12350;19;49;3;27;;30;9920
13/03/2014;9675;12475;18;48;4;26;;30;10048
14/03/2014;9625;12265;17;47;5;25;;30;10065
17/03/2014;9471;11996;14;44;8;22;;30;10144
18/03/2014;9363;11792;13;43;9;21;;30;10092
19/03/2014;9217;11808;12;42;10;20;;30;10081
20/03/2014;9025;11580;11;41;11;19;;30;9962
21/03/2014;8945;11390;10;40;12;18;;30;9923
24/03/2014;8850;10800;7;37;15;15;;30;9825
25/03/2014;8771;10046;6;36;16;14;;30;9451
26/03/2014;8771;9425;5;35;17;13;;30;9142
27/03/2014;8738;9421;4;34;18;12;;30;9148
28/03/2014;8718;9221;3;33;19;11;;30;9037
31/03/2014;8858;11071;0;30;22;8;;30;10481
01/04/2014;8038;9904;29;60;7;38;;45;8328
02/04/2014;7700;9283;28;59;6;37;;43;7921
03/04/2014;7825;9446;27;58;5;36;;41;8023
04/04/2014;7750;9533;26;57;4;35;;39;7933
07/04/2014;7725;9833;23;54;1;32;;33;7789
08/04/2014;7263;9042;22;53;0;31;;31;7263
09/04/2014;7213;9033;21;52;1;30;;31;7272
10/04/2014;6858;8250;20;51;2;29;;31;6948
11/04/2014;6740;8380;19;50;3;28;;31;6899
14/04/2014;6785;8805;16;47;6;25;;31;7176
15/04/2014;6796;9279;15;46;7;24;;31;7357
16/04/2014;6754;9263;14;45;8;23;;31;7401
17/04/2014;6750;9183;13;44;9;22;;31;7456
22/04/2014;6746;9079;8;39;14;17;;31;7800
23/04/2014;6713;8683;7;38;15;16;;31;7666
24/04/2014;6683;8633;6;37;16;15;;31;7689
25/04/2014;6712;8729;5;36;17;14;;31;7818
28/04/2014;6679;8213;2;33;20;11;;31;7669
29/04/2014;6683;8171;1;32;21;10;;31;7691
30/04/2014;8167;9254;0;31;22;9;;31;8938
01/05/2014;8163;9350;30;60;8;38;;46;8369
02/05/2014;8025;9358;29;59;7;37;;44;8237
06/05/2014;7983;9142;25;55;3;33;;36;8080
07/05/2014;7950;9033;24;54;2;32;;34;8014
08/05/2014;8138;9396;23;53;1;31;;32;8177
09/05/2014;8150;9675;22;52;0;30;;30;8150
12/05/2014;7958;9517;19;49;3;27;;30;8114
13/05/2014;7900;9467;18;48;4;26;;30;8109
14/05/2014;8083;10113;17;47;5;25;;30;8421
15/05/2014;8092;10029;16;46;6;24;;30;8479
16/05/2014;8025;9925;15;45;7;23;;30;8468
19/05/2014;7967;9958;12;42;10;20;;30;8631
20/05/2014;7829;9283;11;41;11;19;;30;8362
21/05/2014;7767;8933;10;40;12;18;;30;8233
22/05/2014;7725;8554;9;39;13;17;;30;8084
23/05/2014;7733;8592;8;38;14;16;;30;8134
27/05/2014;7642;8288;4;34;18;12;;30;8030
28/05/2014;7542;7483;3;33;19;11;;30;7505
29/05/2014;7496;7204;2;32;20;10;;30;7301
30/05/2014;7267;8292;1;31;21;9;;30;7985
02/06/2014;7125;8217;28;59;6;37;;43;7277
03/06/2014;6917;8042;27;58;5;36;;41;7054
04/06/2014;6517;7508;26;57;4;35;;39;6619
05/06/2014;6054;7050;25;56;3;34;;37;6135
06/06/2014;5825;6883;24;55;2;33;;35;5885
09/06/2014;5842;6871;21;52;1;30;;31;5875
10/06/2014;5833;6813;20;51;2;29;;31;5896
11/06/2014;5642;6100;19;50;3;28;;31;5686
12/06/2014;5342;5825;18;49;4;27;;31;5404
13/06/2014;5285;5815;17;48;5;26;;31;5370
16/06/2014;5113;5950;14;45;8;23;;31;5329
17/06/2014;4879;5796;13;44;9;22;;31;5145
18/06/2014;4688;5400;12;43;10;21;;31;4918
19/06/2014;4575;5321;11;42;11;20;;31;4840
20/06/2014;4583;5404;10;41;12;19;;31;4901
23/06/2014;4575;5296;7;38;15;16;;31;4924
24/06/2014;4513;4921;6;37;16;15;;31;4724
25/06/2014;4538;4800;5;36;17;14;;31;4682
26/06/2014;4592;4900;4;35;18;13;;31;4771
27/06/2014;4608;5246;3;34;19;12;;31;4999
30/06/2014;5742;7617;0;31;22;9;;31;7073
01/07/2014;5625;7542;30;61;8;39;;47;5951
02/07/2014;5725;7813;29;60;7;38;;45;6050
03/07/2014;5950;8042;28;59;6;37;;43;6242
04/07/2014;6075;8050;27;58;5;36;;41;6316
07/07/2014;5929;7875;24;55;2;33;;35;6040
08/07/2014;5296;7038;23;54;1;32;;33;5349
09/07/2014;5250;6738;22;53;0;31;;31;5250
10/07/2014;5267;6738;21;52;1;30;;31;5314
11/07/2014;5233;6721;20;51;2;29;;31;5329
14/07/2014;5213;6750;17;48;5;26;;31;5461
15/07/2014;5067;6317;16;47;6;25;;31;5309
16/07/2014;4788;5846;15;46;7;24;;31;5027
17/07/2014;4858;5975;14;45;8;23;;31;5146
18/07/2014;4896;6138;13;44;9;22;;31;5257
21/07/2014;4838;5967;10;41;12;19;;31;5275
22/07/2014;4821;5917;9;40;13;18;;31;5281
23/07/2014;4863;6233;8;39;14;17;;31;5482
24/07/2014;4825;6125;7;38;15;16;;31;5454
25/07/2014;4950;6408;6;37;16;15;;31;5703
28/07/2014;4993;6583;3;34;19;12;;31;5968
29/07/2014;4969;6567;2;33;20;11;;31;6000
30/07/2014;4918;6267;1;32;21;10;;31;5832
31/07/2014;5867;7975;0;31;22;9;;31;7363
01/08/2014;5675;7800;30;60;8;38;;46;6045
04/08/2014;5438;7508;27;57;5;35;;40;5697
05/08/2014;5483;7625;26;56;4;34;;38;5708
06/08/2014;5475;7583;25;55;3;33;;36;5651
07/08/2014;5529;7617;24;54;2;32;;34;5652
08/08/2014;5558;7796;23;53;1;31;;32;5628
11/08/2014;5629;8067;20;50;2;28;;30;5792
12/08/2014;5679;8471;19;49;3;27;;30;5958
13/08/2014;5713;8767;18;48;4;26;;30;6120
14/08/2014;6063;9533;17;47;5;25;;30;6641
15/08/2014;6113;9729;16;46;6;24;;30;6836
18/08/2014;5958;9200;13;43;9;21;;30;6931
19/08/2014;5825;8654;12;42;10;20;;30;6768
20/08/2014;5950;9117;11;41;11;19;;30;7111
21/08/2014;5804;8558;10;40;12;18;;30;6906
22/08/2014;5804;8650;9;39;13;17;;30;7037
26/08/2014;5775;8450;5;35;17;13;;30;7291
27/08/2014;5800;8542;4;34;18;12;;30;7445
28/08/2014;5783;8450;3;33;19;11;;30;7472
29/08/2014;8300;11008;2;32;20;10;;30;10105
01/09/2014;8560;11170;29;60;7;38;;45;8966
02/09/2014;8617;11233;28;59;6;37;;43;8982
03/09/2014;8421;10754;27;58;5;36;;41;8706
04/09/2014;8375;10575;26;57;4;35;;39;8601
05/09/2014;8383;10658;25;56;3;34;;37;8567
08/09/2014;8233;10500;22;53;0;31;;31;8233
09/09/2014;8283;10533;21;52;1;30;;31;8356
10/09/2014;7600;9796;20;51;2;29;;31;7742
11/09/2014;7292;9158;19;50;3;28;;31;7473
12/09/2014;7192;8675;18;49;4;27;;31;7383
15/09/2014;7058;8383;15;46;7;24;;31;7357
16/09/2014;6900;7950;14;45;8;23;;31;7171
17/09/2014;7017;8117;13;44;9;22;;31;7336
18/09/2014;7017;8183;12;43;10;21;;31;7393
19/09/2014;7058;8308;11;42;11;20;;31;7502
22/09/2014;6992;8279;8;39;14;17;;31;7573
23/09/2014;6896;7875;7;38;15;16;;31;7370
24/09/2014;6875;7600;6;37;16;15;;31;7249
25/09/2014;6921;7892;5;36;17;14;;31;7453
26/09/2014;6896;7942;4;35;18;13;;31;7503
29/09/2014;6904;7958;1;32;21;10;;31;7618
30/09/2014;7692;8908;0;31;22;9;;31;8555
01/10/2014;8208;9358;30;60;8;38;;46;8408
02/10/2014;8042;9292;29;59;7;37;;44;8241
03/10/2014;8017;9183;28;58;6;36;;42;8184
06/10/2014;7892;9000;25;55;3;33;;36;7984
07/10/2014;7425;8233;24;54;2;32;;34;7473
08/10/2014;7383;8292;23;53;1;31;;32;7411
09/10/2014;7342;8350;22;52;0;30;;30;7342
10/10/2014;7417;8433;21;51;1;29;;30;7451
13/10/2014;7475;8604;18;48;4;26;;30;7626
14/10/2014;7375;8533;17;47;5;25;;30;7568
15/10/2014;7475;8858;16;46;6;24;;30;7752
16/10/2014;7513;8883;15;45;7;23;;30;7833
17/10/2014;7596;9300;14;44;8;22;;30;8050
20/10/2014;7717;9767;11;41;11;19;;30;8469
21/10/2014;7767;10225;10;40;12;18;;30;8750
22/10/2014;7750;10208;9;39;13;17;;30;8815
23/10/2014;7808;9825;8;38;14;16;;30;8749
24/10/2014;7921;10158;7;37;15;15;;30;9040
27/10/2014;7988;10642;4;34;18;12;;30;9580
28/10/2014;8029;10963;3;33;19;11;;30;9887
29/10/2014;7963;10833;2;32;20;10;;30;9876
30/10/2014;7906;10567;1;31;21;9;;30;9769
31/10/2014;11083;10608;0;30;22;8;;30;10735
03/11/2014;10975;10575;27;58;5;36;;41;10926
04/11/2014;10067;9725;26;57;4;35;;39;10032
05/11/2014;9713;9513;25;56;3;34;;37;9697
06/11/2014;9500;9350;24;55;2;33;;35;9491
07/11/2014;9433;9304;23;54;1;32;;33;9429
10/11/2014;9275;9125;20;51;2;29;;31;9265
11/11/2014;9075;8933;19;50;3;28;;31;9061
12/11/2014;9033;8833;18;49;4;27;;31;9007
13/11/2014;8958;8675;17;48;5;26;;31;8912
14/11/2014;8942;8608;16;47;6;25;;31;8877
17/11/2014;8942;8692;13;44;9;22;;31;8869
18/11/2014;9058;8942;12;43;10;21;;31;9021
19/11/2014;9042;8917;11;42;11;20;;31;8998
20/11/2014;9025;8892;10;41;12;19;;31;8974
21/11/2014;9050;8958;9;40;13;18;;31;9011
24/11/2014;9071;9075;6;37;16;15;;31;9073
25/11/2014;9046;9142;5;36;17;14;;31;9099
26/11/2014;8953;8804;4;35;18;13;;31;8866
27/11/2014;9045;9105;3;34;19;12;;31;9082
28/11/2014;9125;8140;2;33;20;11;;31;8490
01/12/2014;8908;7850;30;61;8;39;;47;8728
02/12/2014;8575;7500;29;60;7;38;;45;8408
03/12/2014;8458;7354;28;59;6;37;;43;8304
04/12/2014;8410;7265;27;58;5;36;;41;8270
05/12/2014;8440;7360;26;57;4;35;;39;8329
08/12/2014;8483;7358;23;54;1;32;;33;8449
09/12/2014;8408;7325;22;53;0;31;;31;8408
10/12/2014;8342;7292;21;52;1;30;;31;8308
11/12/2014;8142;6867;20;51;2;29;;31;8060
12/12/2014;8029;6658;19;50;3;28;;31;7896
15/12/2014;7979;6517;16;47;6;25;;31;7696
16/12/2014;8067;6658;15;46;7;24;;31;7749
17/12/2014;8025;6417;14;45;8;23;;31;7610
18/12/2014;8033;6433;13;44;9;22;;31;7568
19/12/2014;8067;6392;12;43;10;21;;31;7527
22/12/2014;8075;6475;9;40;13;18;;31;7404
23/12/2014;8050;6446;8;39;14;17;;31;7326
24/12/2014;6413;6713;7;38;15;16;;31;6558
29/12/2014;6400;6700;2;33;20;11;;31;6594
30/12/2014;6410;6710;1;32;21;10;;31;6613
31/12/2014;6410;6710;0;31;22;9;;31;6623
02/01/2015;6355;6700;29;57;7;35;;42;6413
05/01/2015;5817;6283;26;54;4;32;;36;5869
06/01/2015;5750;6121;25;53;3;31;;34;5783
07/01/2015;5708;6133;24;52;2;30;;32;5735
08/01/2015;5875;6292;23;51;1;29;;30;5889
09/01/2015;6080;6480;22;50;0;28;;28;6080
12/01/2015;6233;6817;19;47;3;25;;28;6296
13/01/2015;6200;6850;18;46;4;24;;28;6293
14/01/2015;6167;6742;17;45;5;23;;28;6270
15/01/2015;6200;6750;16;44;6;22;;28;6318
16/01/2015;6100;6617;15;43;7;21;;28;6229
19/01/2015;6120;6500;12;40;10;18;;28;6256
20/01/2015;6033;6400;11;39;11;17;;28;6177
21/01/2015;5950;6042;10;38;12;16;;28;5989
22/01/2015;5917;5967;9;37;13;15;;28;5940
23/01/2015;5858;5833;8;36;14;14;;28;5846
26/01/2015;5804;5692;5;33;17;11;;28;5736
27/01/2015;5775;5525;4;32;18;10;;28;5614
28/01/2015;5742;5350;3;31;19;9;;28;5476
29/01/2015;5683;4958;2;30;20;8;;28;5165
30/01/2015;4817;5842;1;29;21;7;;28;5586
02/02/2015;4583;5842;26;57;4;35;;39;4712
03/02/2015;4514;5875;25;56;3;34;;37;4624
04/02/2015;4425;5829;24;55;2;33;;35;4505
05/02/2015;4450;5892;23;54;1;32;;33;4494
06/02/2015;4478;6079;22;53;0;31;;31;4478
09/02/2015;4363;6050;19;50;3;28;;31;4526
10/02/2015;4321;6129;18;49;4;27;;31;4554
11/02/2015;4329;6200;17;48;5;26;;31;4631
12/02/2015;4258;6000;16;47;6;25;;31;4595
13/02/2015;4292;6042;15;46;7;24;;31;4687
16/02/2015;4160;5855;12;43;10;21;;31;4707
17/02/2015;4025;5592;11;42;11;20;;31;4581
18/02/2015;4008;5579;10;41;12;19;;31;4616
19/02/2015;3979;5467;9;40;13;18;;31;4603
20/02/2015;3992;5488;8;39;14;17;;31;4668
23/02/2015;3950;5329;5;36;17;14;;31;4706
24/02/2015;3913;5050;4;35;18;13;;31;4573
25/02/2015;3914;5133;3;34;19;12;;31;4661
26/02/2015;3918;5363;2;33;20;11;;31;4850
27/02/2015;5333;6638;1;32;21;10;;31;6217
02/03/2015;5192;6404;29;59;7;37;;44;5385
03/03/2015;5083;6183;28;58;6;36;;42;5240
04/03/2015;5108;6300;27;57;5;35;;40;5257
05/03/2015;4963;5946;26;56;4;34;;38;5066
06/03/2015;4907;5857;25;55;3;33;;36;4986
09/03/2015;4892;5800;22;52;0;30;;30;4892
10/03/2015;4821;5588;21;51;1;29;;30;4847
11/03/2015;4833;5592;20;50;2;28;;30;4884
12/03/2015;4846;5771;19;49;3;27;;30;4939
13/03/2015;4833;5763;18;48;4;26;;30;4957
16/03/2015;4896;6233;15;45;7;23;;30;5208
17/03/2015;4892;6400;14;44;8;22;;30;5294
18/03/2015;4879;6283;13;43;9;21;;30;5300
19/03/2015;4950;6463;12;42;10;20;;30;5454
20/03/2015;4900;6221;11;41;11;19;;30;5384
23/03/2015;4858;6004;8;38;14;16;;30;5393
24/03/2015;4792;5600;7;37;15;15;;30;5196
25/03/2015;4762;5433;6;36;16;14;;30;5120
26/03/2015;4774;5479;5;35;17;13;;30;5174
27/03/2015;4781;5430;4;34;18;12;;30;5170
30/03/2015;4725;5163;1;31;21;9;;30;5032
31/03/2015;5208;5921;0;30;22;8;;30;5731
01/04/2015;5075;5642;29;60;7;38;;45;5163
02/04/2015;5100;5600;28;59;6;37;;43;5170
07/04/2015;4921;5425;23;54;1;32;;33;4936
08/04/2015;5025;5592;22;53;0;31;;31;5025
09/04/2015;5138;5750;21;52;1;30;;31;5158
10/04/2015;5096;5671;20;51;2;29;;31;5133
13/04/2015;5096;5717;17;48;5;26;;31;5196
14/04/2015;5183;5796;16;47;6;25;;31;5302
15/04/2015;5167;5775;15;46;7;24;;31;5304
16/04/2015;5200;5800;14;45;8;23;;31;5355
17/04/2015;5188;5758;13;44;9;22;;31;5353
20/04/2015;5175;5746;10;41;12;19;;31;5396
21/04/2015;5100;5533;9;40;13;18;;31;5282
22/04/2015;5108;5463;8;39;14;17;;31;5268
23/04/2015;5092;5375;7;38;15;16;;31;5229
24/04/2015;5100;5396;6;37;16;15;;31;5253
27/04/2015;5154;5354;3;34;19;12;;31;5277
28/04/2015;5154;5267;2;33;20;11;;31;5227
29/04/2015;5100;4942;1;32;21;10;;31;4993
30/04/2015;4829;4746;0;31;22;9;;31;4770
01/05/2015;4858;4750;30;60;8;38;;46;4839
05/05/2015;4596;4600;26;56;4;34;;38;4596
06/05/2015;4613;4633;25;55;3;33;;36;4615
07/05/2015;4638;4650;24;54;2;32;;34;4639
08/05/2015;4771;4817;23;53;1;31;;32;4772
11/05/2015;4763;4842;20;50;2;28;;30;4768
12/05/2015;4883;5063;19;49;3;27;;30;4901
13/05/2015;4967;5196;18;48;4;26;;30;4998
14/05/2015;4925;5146;17;47;5;25;;30;4962
15/05/2015;4804;4967;16;46;6;24;;30;4837
18/05/2015;4792;4900;13;43;9;21;;30;4824
19/05/2015;4758;4879;12;42;10;20;;30;4798
20/05/2015;4717;4738;11;41;11;19;;30;4725
21/05/2015;4692;4700;10;40;12;18;;30;4695
22/05/2015;4667;4708;9;39;13;17;;30;4685
26/05/2015;4643;4650;5;35;17;13;;30;4647
27/05/2015;4617;4617;4;34;18;12;;30;4617
28/05/2015;4629;4642;3;33;19;11;;30;4637
29/05/2015;4650;5067;2;32;20;10;;30;4928
01/06/2015;4608;5046;29;60;7;38;;45;4676
02/06/2015;4738;5204;28;59;6;37;;43;4803
03/06/2015;4904;5338;27;58;5;36;;41;4957
04/06/2015;5083;5442;26;57;4;35;;39;5120
05/06/2015;5100;5425;25;56;3;34;;37;5126
08/06/2015;5133;5388;22;53;0;31;;31;5133
09/06/2015;5075;5329;21;52;1;30;;31;5083
10/06/2015;5388;5650;20;51;2;29;;31;5405
11/06/2015;5421;5683;19;50;3;28;;31;5446
12/06/2015;5529;5838;18;49;4;27;;31;5569
15/06/2015;5692;6292;15;46;7;24;;31;5827
16/06/2015;5863;6667;14;45;8;23;;31;6070
17/06/2015;5933;6817;13;44;9;22;;31;6190
18/06/2015;5933;6558;12;43;10;21;;31;6135
19/06/2015;5933;6396;11;42;11;20;;31;6097
22/06/2015;5900;6304;8;39;14;17;;31;6082
23/06/2015;5867;6288;7;38;15;16;;31;6071
24/06/2015;5913;6321;6;37;16;15;;31;6124
25/06/2015;5850;6329;5;36;17;14;;31;6113
26/06/2015;5863;6625;4;35;18;13;;31;6305
29/06/2015;5817;6521;1;32;21;10;;31;6294
30/06/2015;6567;6229;0;31;22;9;;31;6327
01/07/2015;6958;6592;30;61;8;39;;47;6896
02/07/2015;7300;6850;29;60;7;38;;45;7230
03/07/2015;7694;7281;28;59;6;37;;43;7636
06/07/2015;7633;7183;25;56;3;34;;37;7597
07/07/2015;7375;6863;24;55;2;33;;35;7346
08/07/2015;7375;6829;23;54;1;32;;33;7358
09/07/2015;7908;7508;22;53;0;31;;31;7908
10/07/2015;8158;7883;21;52;1;30;;31;8149
13/07/2015;8463;8129;18;49;4;27;;31;8420
14/07/2015;8550;8225;17;48;5;26;;31;8498
15/07/2015;8767;8692;16;47;6;25;;31;8752
16/07/2015;8658;8400;15;46;7;24;;31;8600
17/07/2015;8680;8340;14;45;8;23;;31;8592
20/07/2015;8742;8442;11;42;11;20;;31;8636
21/07/2015;8604;8192;10;41;12;19;;31;8445
22/07/2015;8542;8050;9;40;13;18;;31;8336
23/07/2015;8483;7825;8;39;14;17;;31;8186
24/07/2015;8475;7775;7;38;15;16;;31;8136
27/07/2015;8483;7908;4;35;18;13;;31;8149
28/07/2015;8450;7783;3;34;19;12;;31;8041
29/07/2015;8429;7825;2;33;20;11;;31;8039
30/07/2015;8442;7700;1;32;21;10;;31;7939
31/07/2015;7817;7875;0;31;22;9;;31;7858
03/08/2015;7850;8117;28;58;6;36;;42;7888
04/08/2015;8100;8392;27;57;5;35;;40;8137
05/08/2015;8179;8500;26;56;4;34;;38;8213
06/08/2015;8258;8500;25;55;3;33;;36;8278
07/08/2015;8483;8738;24;54;2;32;;34;8498
10/08/2015;8717;9225;21;51;1;29;;30;8734
11/08/2015;8458;8625;20;50;2;28;;30;8469
12/08/2015;8275;8246;19;49;3;27;;30;8272
13/08/2015;8271;8221;18;48;4;26;;30;8264
14/08/2015;8308;8433;17;47;5;25;;30;8329
17/08/2015;8263;8296;14;44;8;22;;30;8272
18/08/2015;8179;8113;13;43;9;21;;30;8159
19/08/2015;8167;8108;12;42;10;20;;30;8147
20/08/2015;8250;8367;11;41;11;19;;30;8293
21/08/2015;8263;8392;10;40;12;18;;30;8315
24/08/2015;8204;7933;7;37;15;15;;30;8069
25/08/2015;8225;7875;6;36;16;14;;30;8038
26/08/2015;8213;7467;5;35;17;13;;30;7790
27/08/2015;8187;7042;4;34;18;12;;30;7500
28/08/2015;7042;7308;3;33;19;11;;30;7210
01/09/2015;6892;7225;29;60;7;38;;45;6944
02/09/2015;6692;6967;28;59;6;37;;43;6730
03/09/2015;6525;6817;27;58;5;36;;41;6561
04/09/2015;6529;6858;26;57;4;35;;39;6563
07/09/2015;6560;7000;23;54;1;32;;33;6573
08/09/2015;6538;6963;22;53;0;31;;31;6538
09/09/2015;6438;6758;21;52;1;30;;31;6448
10/09/2015;6321;6558;20;51;2;29;;31;6336
11/09/2015;6275;6550;19;50;3;28;;31;6302
14/09/2015;6263;6825;16;47;6;25;;31;6372
15/09/2015;6283;6921;15;46;7;24;;31;6427
16/09/2015;6408;7158;14;45;8;23;;31;6602
17/09/2015;6433;7321;13;44;9;22;;31;6691
18/09/2015;6475;7529;12;43;10;21;;31;6815
21/09/2015;6400;7250;9;40;13;18;;31;6756
22/09/2015;6288;7042;8;39;14;17;;31;6629
23/09/2015;6242;6967;7;38;15;16;;31;6593
24/09/2015;6225;7010;6;37;16;15;;31;6630
25/09/2015;6225;7054;5;36;17;14;;31;6680
28/09/2015;6190;6796;2;33;20;11;;31;6581
29/09/2015;6183;6525;1;32;21;10;;31;6415
30/09/2015;6367;7325;0;31;22;9;;31;7047
01/10/2015;6458;7417;30;60;8;38;;46;6625
02/10/2015;6383;7392;29;59;7;37;;44;6544
05/10/2015;6429;7458;26;56;4;34;;38;6537
06/10/2015;6375;7500;25;55;3;33;;36;6469
07/10/2015;6508;7700;24;54;2;32;;34;6578
08/10/2015;6700;7933;23;53;1;31;;32;6739
09/10/2015;6675;7875;22;52;0;30;;30;6675
12/10/2015;6513;7638;19;49;3;27;;30;6626
13/10/2015;6225;7058;18;48;4;26;;30;6336
14/10/2015;5858;6592;17;47;5;25;;30;5980
15/10/2015;5829;6600;16;46;6;24;;30;5983
16/10/2015;5871;6754;15;45;7;23;;30;6077
19/10/2015;5829;6692;12;42;10;20;;30;6117
20/10/2015;5740;6590;11;41;11;19;;30;6052
21/10/2015;5655;6275;10;40;12;18;;30;5903
22/10/2015;5665;6330;9;39;13;17;;30;5953
23/10/2015;5655;6315;8;38;14;16;;30;5963
26/10/2015;5655;6245;5;35;17;13;;30;5989
27/10/2015;5660;6190;4;34;18;12;;30;5978
28/10/2015;5650;6100;3;33;19;11;;30;5935
29/10/2015;5670;5910;2;32;20;10;;30;5830
30/10/2015;5880;6090;1;31;21;9;;30;6027
02/11/2015;5650;5870;28;59;6;37;;43;5681
03/11/2015;5370;5685;27;58;5;36;;41;5408
04/11/2015;4990;5290;26;57;4;35;;39;5021
05/11/2015;4990;5370;25;56;3;34;;37;5021
06/11/2015;4870;5160;24;55;2;33;;35;4887
09/11/2015;4860;5080;21;52;1;30;;31;4867
10/11/2015;4720;4975;20;51;2;29;;31;4736
11/11/2015;4460;4760;19;50;3;28;;31;4489
12/11/2015;4350;4540;18;49;4;27;;31;4375
13/11/2015;4370;4520;17;48;5;26;;31;4394
16/11/2015;4345;4490;14;45;8;23;;31;4382
17/11/2015;4380;4460;13;44;9;22;;31;4403
18/11/2015;4310;4430;12;43;10;21;;31;4349
19/11/2015;4290;4255;11;42;11;20;;31;4278
20/11/2015;4285;4255;10;41;12;19;;31;4273
23/11/2015;4325;4415;7;38;15;16;;31;4369
24/11/2015;4275;4345;6;37;16;15;;31;4311
25/11/2015;4295;4405;5;36;17;14;;31;4355
26/11/2015;4260;4090;4;35;18;13;;31;4161
27/11/2015;4225;3985;3;34;19;12;;31;4078
30/11/2015;3970;4340;0;31;22;9;;31;4233
01/12/2015;3795;4075;30;61;8;39;;47;3843
02/12/2015;3735;3945;29;60;7;38;;45;3768
03/12/2015;3615;3890;28;59;6;37;;43;3653
04/12/2015;3600;3855;27;58;5;36;;41;3631
07/12/2015;3560;3875;24;55;2;33;;35;3578
08/12/2015;3535;3950;23;54;1;32;;33;3548
09/12/2015;3490;3905;22;53;0;31;;31;3490
10/12/2015;3380;3630;21;52;1;30;;31;3388
11/12/2015;3400;3670;20;51;2;29;;31;3417
14/12/2015;3410;3715;17;48;5;26;;31;3459
15/12/2015;3410;3805;16;47;6;25;;31;3486
16/12/2015;3430;4025;15;46;7;24;;31;3564
17/12/2015;3435;4165;14;45;8;23;;31;3623
18/12/2015;3440;4185;13;44;9;22;;31;3656
21/12/2015;3440;4195;10;41;12;19;;31;3732
22/12/2015;3420;4145;9;40;13;18;;31;3724
23/12/2015;3432;4180;8;39;14;17;;31;3770
24/12/2015;4290;4870;7;38;15;16;;31;4571
29/12/2015;4280;4840;2;33;20;11;;31;4641
30/12/2015;4250;4810;1;32;21;10;;31;4629
31/12/2015;4260;4810;0;31;22;9;;31;4650
04/01/2016;4010;4570;27;56;5;34;;39;4082
05/01/2016;3950;4430;26;55;4;33;;37;4002
06/01/2016;3795;4105;25;54;3;32;;35;3822
07/01/2016;3580;3770;24;53;2;31;;33;3592
08/01/2016;3390;3630;23;52;1;30;;31;3398
11/01/2016;3380;3745;20;49;2;27;;29;3405
12/01/2016;3375;3750;19;48;3;26;;29;3414
13/01/2016;3250;3535;18;47;4;25;;29;3289
14/01/2016;3120;3180;17;46;5;24;;29;3130
15/01/2016;3075;3225;16;45;6;23;;29;3106
18/01/2016;3150;3440;13;42;9;20;;29;3240
19/01/2016;3195;3480;12;41;10;19;;29;3293
20/01/2016;3110;3130;11;40;11;18;;29;3118
21/01/2016;3075;2965;10;39;12;17;;29;3029
22/01/2016;3080;3000;9;38;13;16;;29;3044
25/01/2016;3070;2955;6;35;16;13;;29;3007
26/01/2016;3050;2805;5;34;17;12;;29;2906
27/01/2016;3028;2595;4;33;18;11;;29;2759
28/01/2016;3000;2625;3;32;19;10;;29;2754
29/01/2016;2660;3290;2;31;20;9;;29;3094
01/02/2016;2760;3575;28;59;6;37;;43;2874
02/02/2016;2640;3530;27;58;5;36;;41;2749
03/02/2016;2740;3665;26;57;4;35;;39;2835
04/02/2016;2775;3725;25;56;3;34;;37;2852
05/02/2016;2637;3655;24;55;2;33;;35;2695
08/02/2016;2595;3585;21;52;1;30;;31;2627
09/02/2016;2515;3435;20;51;2;29;;31;2574
10/02/2016;2545;3515;19;50;3;28;;31;2639
11/02/2016;2645;3715;18;49;4;27;;31;2783
12/02/2016;2700;3820;17;48;5;26;;31;2881
15/02/2016;2725;3880;14;45;8;23;;31;3023
16/02/2016;2710;3790;13;44;9;22;;31;3024
17/02/2016;2710;3710;12;43;10;21;;31;3033
18/02/2016;2645;3495;11;42;11;20;;31;2947
19/02/2016;2620;3420;10;41;12;19;;31;2930
22/02/2016;2555;3105;7;38;15;16;;31;2821
23/02/2016;2550;3015;6;37;16;15;;31;2790
24/02/2016;2575;3095;5;36;17;14;;31;2860
25/02/2016;2580;3285;4;35;18;13;;31;2989
26/02/2016;2585;3360;3;34;19;12;;31;3060
29/02/2016;3395;4125;0;31;22;9;;31;3913
01/03/2016;3348;4135;30;60;8;38;;46;3485
02/03/2016;3450;4350;29;59;7;37;;44;3593
03/03/2016;3615;4630;28;58;6;36;;42;3760
04/03/2016;3615;4660;27;57;5;35;;40;3746
07/03/2016;3690;4960;24;54;2;32;;34;3765
08/03/2016;3830;5295;23;53;1;31;;32;3876
09/03/2016;3785;5160;22;52;0;30;;30;3785
10/03/2016;3725;4950;21;51;1;29;;30;3766
11/03/2016;3645;4645;20;50;2;28;;30;3712
14/03/2016;3610;4490;17;47;5;25;;30;3757
15/03/2016;3610;4480;16;46;6;24;;30;3784
16/03/2016;3470;4270;15;45;7;23;;30;3657
17/03/2016;3460;4230;14;44;8;22;;30;3665
18/03/2016;3465;4190;13;43;9;21;;30;3683
21/03/2016;3470;4135;10;40;12;18;;30;3736
22/03/2016;3470;4015;9;39;13;17;;30;3706
23/03/2016;3520;4290;8;38;14;16;;30;3879
24/03/2016;3525;4360;7;37;15;15;;30;3943
29/03/2016;3520;4445;2;32;20;10;;30;4137
30/03/2016;3535;4855;1;31;21;9;;30;4459
31/03/2016;4860;5110;0;30;22;8;;30;5043
01/04/2016;5065;5325;29;60;7;38;;45;5105
04/04/2016;5400;5535;26;57;4;35;;39;5414
05/04/2016;5370;5470;25;56;3;34;;37;5378
06/04/2016;5250;5280;24;55;2;33;;35;5252
07/04/2016;5020;5095;23;54;1;32;;33;5022
08/04/2016;5070;5155;22;53;0;31;;31;5070
11/04/2016;5035;5090;19;50;3;28;;31;5040
12/04/2016;5115;5115;18;49;4;27;;31;5115
13/04/2016;5285;5375;17;48;5;26;;31;5300
14/04/2016;5630;5815;16;47;6;25;;31;5666
15/04/2016;5835;6570;15;46;7;24;;31;6001
18/04/2016;5615;6175;12;43;10;21;;31;5796
19/04/2016;5590;5980;11;42;11;20;;31;5728
20/04/2016;5440;5650;10;41;12;19;;31;5521
21/04/2016;5505;5945;9;40;13;18;;31;5690
22/04/2016;5505;6125;8;39;14;17;;31;5785
25/04/2016;5480;5925;5;36;17;14;;31;5724
26/04/2016;5455;5505;4;35;18;13;;31;5484
27/04/2016;5431;5295;3;34;19;12;;31;5348
28/04/2016;5415;5215;2;33;20;11;;31;5286
29/04/2016;5100;4995;1;32;21;10;;31;5029
03/05/2016;4760;4680;28;58;6;36;;42;4749
04/05/2016;4830;4790;27;57;5;35;;40;4825
05/05/2016;5010;5010;26;56;4;34;;38;5010
06/05/2016;4845;4855;25;55;3;33;;36;4846
09/05/2016;4860;4950;22;52;0;30;;30;4860
10/05/2016;5060;5265;21;51;1;29;;30;5067
11/05/2016;5040;5285;20;50;2;28;;30;5056
12/05/2016;5040;5325;19;49;3;27;;30;5069
13/05/2016;5005;5375;18;48;4;26;;30;5054
16/05/2016;5000;5405;15;45;7;23;;30;5095
17/05/2016;4920;5165;14;44;8;22;;30;4985
18/05/2016;4900;5140;13;43;9;21;;30;4972
19/05/2016;4950;5290;12;42;10;20;;30;5063
20/05/2016;4950;5200;11;41;11;19;;30;5042
23/05/2016;4895;5070;8;38;14;16;;30;4977
24/05/2016;4857;4975;7;37;15;15;;30;4916
25/05/2016;4835;4855;6;36;16;14;;30;4846
26/05/2016;4823;4940;5;35;17;13;;30;4889
27/05/2016;4823;4995;4;34;18;12;;30;4926
31/05/2016;4920;4895;0;30;22;8;;30;4902
01/06/2016;4675;4705;29;60;7;38;;45;4680
02/06/2016;4620;4670;28;59;6;37;;43;4627
03/06/2016;4460;4530;27;58;5;36;;41;4469
06/06/2016;4460;4595;24;55;2;33;;35;4468
07/06/2016;4480;4710;23;54;1;32;;33;4487
08/06/2016;4630;4875;22;53;0;31;;31;4630
09/06/2016;4655;4945;21;52;1;30;;31;4664
10/06/2016;4635;4960;20;51;2;29;;31;4656
13/06/2016;4550;4735;17;48;5;26;;31;4580
14/06/2016;4525;4735;16;47;6;25;;31;4566
15/06/2016;4530;4850;15;46;7;24;;31;4602
16/06/2016;4520;4830;14;45;8;23;;31;4600
17/06/2016;4500;4750;13;44;9;22;;31;4573
20/06/2016;4505;4765;10;41;12;19;;31;4606
21/06/2016;4475;4830;9;40;13;18;;31;4624
22/06/2016;4492;4920;8;39;14;17;;31;4685
23/06/2016;4503;5060;7;38;15;16;;31;4773
24/06/2016;4505;5060;6;37;16;15;;31;4791
27/06/2016;4510;5250;3;34;19;12;;31;4964
28/06/2016;4520;5360;2;33;20;11;;31;5062
29/06/2016;4530;5770;1;32;21;10;;31;5370
30/06/2016;6060;6130;0;31;22;9;;31;6110
01/07/2016;6140;6265;30;61;8;39;;47;6161
04/07/2016;6175;6290;27;58;5;36;;41;6189
05/07/2016;6175;6320;26;57;4;35;;39;6190
06/07/2016;6490;6520;25;56;3;34;;37;6492
07/07/2016;6375;6430;24;55;2;33;;35;6378
08/07/2016;6475;6490;23;54;1;32;;33;6475
11/07/2016;6380;6420;20;51;2;29;;31;6383
12/07/2016;6375;6420;19;50;3;28;;31;6379
13/07/2016;6505;6645;18;49;4;27;;31;6523
14/07/2016;6720;6980;17;48;5;26;;31;6762
15/07/2016;6795;7020;16;47;6;25;;31;6839
18/07/2016;6635;6770;13;44;9;22;;31;6674
19/07/2016;6470;6525;12;43;10;21;;31;6488
20/07/2016;6445;6365;11;42;11;20;;31;6417
21/07/2016;6395;6035;10;41;12;19;;31;6256
22/07/2016;6365;5795;9;40;13;18;;31;6126
25/07/2016;6400;5760;6;37;16;15;;31;6070
26/07/2016;6413;5663;5;36;17;14;;31;6002
27/07/2016;6406;5500;4;35;18;13;;31;5880
28/07/2016;6394;5365;3;34;19;12;;31;5763
29/07/2016;5265;5445;2;33;20;11;;31;5381
01/08/2016;5240;5405;30;60;8;38;;46;5269
02/08/2016;5535;5780;29;59;7;37;;44;5574
03/08/2016;5520;5875;28;58;6;36;;42;5571
04/08/2016;5425;5855;27;57;5;35;;40;5479
05/08/2016;5550;6140;26;56;4;34;;38;5612
08/08/2016;5580;6270;23;53;1;31;;32;5602
09/08/2016;5530;6295;22;52;0;30;;30;5530
10/08/2016;5680;6545;21;51;1;29;;30;5709
11/08/2016;5680;6550;20;50;2;28;;30;5738
12/08/2016;5660;6490;19;49;3;27;;30;5743
15/08/2016;5620;6480;16;46;6;24;;30;5792
16/08/2016;5475;6235;15;45;7;23;;30;5652
17/08/2016;5515;6350;14;44;8;22;;30;5738
18/08/2016;5570;6425;13;43;9;21;;30;5827
19/08/2016;5570;6370;12;42;10;20;;30;5837
22/08/2016;5525;6200;9;39;13;17;;30;5818
23/08/2016;5510;6040;8;38;14;16;;30;5757
24/08/2016;5490;6010;7;37;15;15;;30;5750
25/08/2016;5485;6010;6;36;16;14;;30;5765
26/08/2016;5440;5860;5;35;17;13;;30;5678
30/08/2016;5445;5655;1;31;21;9;;30;5592
31/08/2016;5560;6285;0;30;22;8;;30;6092
01/09/2016;5600;6380;29;60;7;38;;45;5721
02/09/2016;5650;6475;28;59;6;37;;43;5765
05/09/2016;5635;6545;25;56;3;34;;37;5709
06/09/2016;5700;6640;24;55;2;33;;35;5754
07/09/2016;5755;6890;23;54;1;32;;33;5789
08/09/2016;5655;6745;22;53;0;31;;31;5655
09/09/2016;5650;6705;21;52;1;30;;31;5684
12/09/2016;5560;6595;18;49;4;27;;31;5694
13/09/2016;5395;6385;17;48;5;26;;31;5555
14/09/2016;5325;6240;16;47;6;25;;31;5502
15/09/2016;5420;6515;15;46;7;24;;31;5667
16/09/2016;5385;6565;14;45;8;23;;31;5690
19/09/2016;5385;6665;11;42;11;20;;31;5839
20/09/2016;5320;6535;10;41;12;19;;31;5790
21/09/2016;5395;6790;9;40;13;18;;31;5980
22/09/2016;5435;6920;8;39;14;17;;31;6106
23/09/2016;5415;6845;7;38;15;16;;31;6107
26/09/2016;5400;6755;4;35;18;13;;31;6187
27/09/2016;5400;6620;3;34;19;12;;31;6148
28/09/2016;5390;6185;2;33;20;11;;31;5903
29/09/2016;5390;6150;1;32;21;10;;31;5905
30/09/2016;6170;6480;0;31;22;9;;31;6390
03/10/2016;6115;6475;28;58;6;36;;42;6166
04/10/2016;6185;6555;27;57;5;35;;40;6231
05/10/2016;6150;6655;26;56;4;34;;38;6203
06/10/2016;6240;6800;25;55;3;33;;36;6287
07/10/2016;6255;6860;24;54;2;32;;34;6291
10/10/2016;6260;6970;21;51;1;29;;30;6284
11/10/2016;6205;6905;20;50;2;28;;30;6252
12/10/2016;6235;6915;19;49;3;27;;30;6303
13/10/2016;6360;7125;18;48;4;26;;30;6462
14/10/2016;6400;7115;17;47;5;25;;30;6519
17/10/2016;6475;7145;14;44;8;22;;30;6654
18/10/2016;6570;7345;13;43;9;21;;30;6803
19/10/2016;6590;7265;12;42;10;20;;30;6815
20/10/2016;6505;7055;11;41;11;19;;30;6707
21/10/2016;6515;7045;10;40;12;18;;30;6727
24/10/2016;6525;7040;7;37;15;15;;30;6783
25/10/2016;6535;7020;6;36;16;14;;30;6794
26/10/2016;6545;7130;5;35;17;13;;30;6877
27/10/2016;6535;7100;4;34;18;12;;30;6874
28/10/2016;6545;7145;3;33;19;11;;30;6925
31/10/2016;7100;6425;0;30;22;8;;30;6605
01/11/2016;6875;6320;29;60;7;38;;45;6789
02/11/2016;6760;6320;28;59;6;37;;43;6699
03/11/2016;6990;6585;27;58;5;36;;41;6941
04/11/2016;7060;6695;26;57;4;35;;39;7023
07/11/2016;7170;6865;23;54;1;32;;33;7161
08/11/2016;7420;7110;22;53;0;31;;31;7420
09/11/2016;7530;7200;21;52;1;30;;31;7519
10/11/2016;7860;7725;20;51;2;29;;31;7851
11/11/2016;8365;8335;19;50;3;28;;31;8362
14/11/2016;8470;8270;16;47;6;25;;31;8431
15/11/2016;8815;8845;15;46;7;24;;31;8822
16/11/2016;9080;9400;14;45;8;23;;31;9163
17/11/2016;9150;9390;13;44;9;22;;31;9220
18/11/2016;9120;9325;12;43;10;21;;31;9186
21/11/2016;8960;8820;9;40;13;18;;31;8901
22/11/2016;9030;9080;8;39;14;17;;31;9053
23/11/2016;9120;9370;7;38;15;16;;31;9241
24/11/2016;9105;9060;6;37;16;15;;31;9082
25/11/2016;9110;9105;5;36;17;14;;31;9107
28/11/2016;9195;9785;2;33;20;11;;31;9576
29/11/2016;9245;10360;1;32;21;10;;31;10000
30/11/2016;10710;8325;0;31;22;9;;31;9017
01/12/2016;10660;8230;30;61;8;39;;47;10246
02/12/2016;11010;8720;29;60;7;38;;45;10654
05/12/2016;11620;9570;26;57;4;35;;39;11410
06/12/2016;11600;8990;25;56;3;34;;37;11388
07/12/2016;11325;8360;24;55;2;33;;35;11156
08/12/2016;11110;7840;23;54;1;32;;33;11011
09/12/2016;11100;7850;22;53;0;31;;31;11100
12/12/2016;11140;8020;19;50;3;28;;31;10838
13/12/2016;10990;7725;18;49;4;27;;31;10569
14/12/2016;10400;6830;17;48;5;26;;31;9824
15/12/2016;10400;6794;16;47;6;25;;31;9702
16/12/2016;10330;6655;15;46;7;24;;31;9500
19/12/2016;10290;6460;12;43;10;21;;31;9055
20/12/2016;10290;6350;11;42;11;20;;31;8892
21/12/2016;10270;6335;10;41;12;19;;31;8747
22/12/2016;10260;6280;9;40;13;18;;31;8591
23/12/2016;6415;6270;8;39;14;17;;31;6350
03/01/2017;6795;6690;28;56;6;34;;40;6779
04/01/2017;6840;6855;27;55;5;33;;38;6842
05/01/2017;7360;7265;26;54;4;32;;36;7349
06/01/2017;7550;7410;25;53;3;31;;34;7538
09/01/2017;7490;7320;22;50;0;28;;28;7490
10/01/2017;7550;7325;21;49;1;27;;28;7542
11/01/2017;7525;7190;20;48;2;26;;28;7501
12/01/2017;7315;6800;19;47;3;25;;28;7260
13/01/2017;7305;6780;18;46;4;24;;28;7230
16/01/2017;7370;6880;15;43;7;21;;28;7248
17/01/2017;7305;6705;14;42;8;20;;28;7134
18/01/2017;7330;6780;13;41;9;19;;28;7153
19/01/2017;7335;6835;12;40;10;18;;28;7156
20/01/2017;7385;7085;11;39;11;17;;28;7267
23/01/2017;7455;7260;8;36;14;14;;28;7358
24/01/2017;7560;7415;7;35;15;13;;28;7482
25/01/2017;7595;7790;6;34;16;12;;28;7706
26/01/2017;7620;7620;5;33;17;11;;28;7620
27/01/2017;7600;7570;4;32;18;10;;28;7581
30/01/2017;7610;7515;1;29;21;7;;28;7539
31/01/2017;7425;7770;0;28;22;6;;28;7696
01/02/2017;7625;8085;27;58;5;36;;41;7681
02/02/2017;7780;8370;26;57;4;35;;39;7841
03/02/2017;7850;8670;25;56;3;34;;37;7916
06/02/2017;7830;8690;22;53;0;31;;31;7830
07/02/2017;7470;8090;21;52;1;30;;31;7490
08/02/2017;7525;8370;20;51;2;29;;31;7580
09/02/2017;7555;8410;19;50;3;28;;31;7638
10/02/2017;7525;8405;18;49;4;27;;31;7639
13/02/2017;7670;8605;15;46;7;24;;31;7881
14/02/2017;7405;8200;14;45;8;23;;31;7610
15/02/2017;7260;7990;13;44;9;22;;31;7472
16/02/2017;7240;7965;12;43;10;21;;31;7474
17/02/2017;7340;8180;11;42;11;20;;31;7638
20/02/2017;7360;8445;8;39;14;17;;31;7850
21/02/2017;7405;8495;7;38;15;16;;31;7932
22/02/2017;7455;8635;6;37;16;15;;31;8064
23/02/2017;7510;8940;5;36;17;14;;31;8294
24/02/2017;7495;9060;4;35;18;13;;31;8404
27/02/2017;7460;8870;1;32;21;10;;31;8415
28/02/2017;9330;10210;0;31;22;9;;31;9955
01/03/2017;9920;10610;30;60;8;38;;46;10040
02/03/2017;10025;10670;29;59;7;37;;44;10128
03/03/2017;10295;10925;28;58;6;36;;42;10385
06/03/2017;10470;11330;25;55;3;33;;36;10542
07/03/2017;10410;11270;24;54;2;32;;34;10461
08/03/2017;9860;10530;23;53;1;31;;32;9881
09/03/2017;9920;10540;22;52;0;30;;30;9920
10/03/2017;9790;10280;21;51;1;29;;30;9806
13/03/2017;9745;10400;18;48;4;26;;30;9832
14/03/2017;9605;10155;17;47;5;25;;30;9697
15/03/2017;9425;9860;16;46;6;24;;30;9512
16/03/2017;9270;9970;15;45;7;23;;30;9433
17/03/2017;9190;9880;14;44;8;22;;30;9374
20/03/2017;9160;9840;11;41;11;19;;30;9409
21/03/2017;9255;10435;10;40;12;18;;30;9727
22/03/2017;9250;10450;9;39;13;17;;30;9770
23/03/2017;9380;11480;8;38;14;16;;30;10360
24/03/2017;9480;11825;7;37;15;15;;30;10653
27/03/2017;9520;11900;4;34;18;12;;30;10948
28/03/2017;9510;11610;3;33;19;11;;30;10840
29/03/2017;9535;11815;2;32;20;10;;30;11055
30/03/2017;9530;11480;1;31;21;9;;30;10895
31/03/2017;11770;11310;0;30;22;8;;30;11433
03/04/2017;11360;11160;27;58;5;36;;41;11336
04/04/2017;10810;11120;26;57;4;35;;39;10842
05/04/2017;11410;11775;25;56;3;34;;37;11440
06/04/2017;12400;12770;24;55;2;33;;35;12421
07/04/2017;12550;12780;23;54;1;32;;33;12557
10/04/2017;12480;12850;20;51;2;29;;31;12504
11/04/2017;12630;13100;19;50;3;28;;31;12675
12/04/2017;12390;12650;18;49;4;27;;31;12424
13/04/2017;12500;12740;17;48;5;26;;31;12539
18/04/2017;12040;11420;12;43;10;21;;31;11840
19/04/2017;12040;11270;11;42;11;20;;31;11767
20/04/2017;11820;10330;10;41;12;19;;31;11243
21/04/2017;11840;10405;9;40;13;18;;31;11238
24/04/2017;11840;10455;6;37;16;15;;31;11125
25/04/2017;11800;10360;5;36;17;14;;31;11010
26/04/2017;11720;9860;4;35;18;13;;31;10640
27/04/2017;11640;9560;3;34;19;12;;31;10365
28/04/2017;8920;9115;2;33;20;11;;31;9046
02/05/2017;8660;8820;29;59;7;37;;44;8685
03/05/2017;8430;8595;28;58;6;36;;42;8454
04/05/2017;8310;8450;27;57;5;35;;40;8328
05/05/2017;8500;8810;26;56;4;34;;38;8533
08/05/2017;8630;8970;23;53;1;31;;32;8641
09/05/2017;8675;9190;22;52;0;30;;30;8675
10/05/2017;8605;9175;21;51;1;29;;30;8624
11/05/2017;8350;8870;20;50;2;28;;30;8385
12/05/2017;7980;8120;19;49;3;27;;30;7994
15/05/2017;7705;7535;16;46;6;24;;30;7671
16/05/2017;7665;7480;15;45;7;23;;30;7622
17/05/2017;7485;6955;14;44;8;22;;30;7344
18/05/2017;7540;7280;13;43;9;21;;30;7462
19/05/2017;7510;7245;12;42;10;20;;30;7422
22/05/2017;7590;7505;9;39;13;17;;30;7553
23/05/2017;7560;7545;8;38;14;16;;30;7553
24/05/2017;7500;7300;7;37;15;15;;30;7400
25/05/2017;7500;7330;6;36;16;14;;30;7409
26/05/2017;7500;7320;5;35;17;13;;30;7398
30/05/2017;7490;7140;1;31;21;9;;30;7245
31/05/2017;6835;7460;0;30;22;8;;30;7293
01/06/2017;6425;6950;29;60;7;38;;45;6507
02/06/2017;6455;7100;28;59;6;37;;43;6545
05/06/2017;6420;7115;25;56;3;34;;37;6476
06/06/2017;6505;7370;24;55;2;33;;35;6554
07/06/2017;6800;7850;23;54;1;32;;33;6832
08/06/2017;6980;8280;22;53;0;31;;31;6980
09/06/2017;7150;8430;21;52;1;30;;31;7191
12/06/2017;7190;8490;18;49;4;27;;31;7358
13/06/2017;7380;8785;17;48;5;26;;31;7607
14/06/2017;7595;8875;16;47;6;25;;31;7843
15/06/2017;7340;8410;15;46;7;24;;31;7582
16/06/2017;7380;8575;14;45;8;23;;31;7688
19/06/2017;7510;8975;11;42;11;20;;31;8030
20/06/2017;7550;9125;10;41;12;19;;31;8160
21/06/2017;7660;9775;9;40;13;18;;31;8547
22/06/2017;7690;9655;8;39;14;17;;31;8577
23/06/2017;7685;9700;7;38;15;16;;31;8660
26/06/2017;7625;9310;4;35;18;13;;31;8603
27/06/2017;7645;9440;3;34;19;12;;31;8745
28/06/2017;7590;8960;2;33;20;11;;31;8474
29/06/2017;7530;8470;1;32;21;10;;31;8167
30/06/2017;8780;8640;0;31;22;9;;31;8681
03/07/2017;8930;8750;28;59;6;37;;43;8905
04/07/2017;8950;8620;27;58;5;36;;41;8910
05/07/2017;8930;8740;26;57;4;35;;39;8911
06/07/2017;8950;8810;25;56;3;34;;37;8939
07/07/2017;9050;8950;24;55;2;33;;35;9044
10/07/2017;9100;9170;21;52;1;30;;31;9102
11/07/2017;9170;9680;20;51;2;29;;31;9203
12/07/2017;9240;10060;19;50;3;28;;31;9319
13/07/2017;9255;10110;18;49;4;27;;31;9365
14/07/2017;9380;10120;17;48;5;26;;31;9499
17/07/2017;9440;10170;14;45;8;23;;31;9628
18/07/2017;9390;9910;13;44;9;22;;31;9541
19/07/2017;9390;9760;12;43;10;21;;31;9509
20/07/2017;9370;9645;11;42;11;20;;31;9468
21/07/2017;9300;9360;10;41;12;19;;31;9323
24/07/2017;9210;9215;7;38;15;16;;31;9212
25/07/2017;9175;9060;6;37;16;15;;31;9116
26/07/2017;9095;8570;5;36;17;14;;31;8807
27/07/2017;9100;8630;4;35;18;13;;31;8827
28/07/2017;9105;8615;3;34;19;12;;31;8805
31/07/2017;9155;9685;0;31;22;9;;31;9531
01/08/2017;9410;9870;30;60;8;38;;46;9490
02/08/2017;9545;9905;29;59;7;37;;44;9602
03/08/2017;9590;9875;28;58;6;36;;42;9631
04/08/2017;9560;9835;27;57;5;35;;40;9594
07/08/2017;9390;9735;24;54;2;32;;34;9410
08/08/2017;9640;10050;23;53;1;31;;32;9653
09/08/2017;9790;10075;22;52;0;30;;30;9790
10/08/2017;9970;10470;21;51;1;29;;30;9987
11/08/2017;10135;10485;20;50;2;28;;30;10158
14/08/2017;10030;10320;17;47;5;25;;30;10078
15/08/2017;10150;10690;16;46;6;24;;30;10258
16/08/2017;10315;11045;15;45;7;23;;30;10485
17/08/2017;10300;10820;14;44;8;22;;30;10439
18/08/2017;10240;10795;13;43;9;21;;30;10407
21/08/2017;10120;10610;10;40;12;18;;30;10316
22/08/2017;10060;10350;9;39;13;17;;30;10186
23/08/2017;9910;10020;8;38;14;16;;30;9961
24/08/2017;9900;10110;7;37;15;15;;30;10005
25/08/2017;9910;10260;6;36;16;14;;30;10097
29/08/2017;9900;10100;2;32;20;10;;30;10033
30/08/2017;9910;10170;1;31;21;9;;30;10092
31/08/2017;10640;12040;0;30;22;8;;30;11667
01/09/2017;10910;12380;29;60;7;38;;45;11139
04/09/2017;11450;12760;26;57;4;35;;39;11584
05/09/2017;11160;12310;25;56;3;34;;37;11253
06/09/2017;11300;12590;24;55;2;33;;35;11374
07/09/2017;11480;12680;23;54;1;32;;33;11516
08/09/2017;11360;12470;22;53;0;31;;31;11360
11/09/2017;11430;12510;19;50;3;28;;31;11535
12/09/2017;11490;12620;18;49;4;27;;31;11636
13/09/2017;11760;12930;17;48;5;26;;31;11949
14/09/2017;11740;13080;16;47;6;25;;31;11999
15/09/2017;11695;12960;15;46;7;24;;31;11981
18/09/2017;11600;12730;12;43;10;21;;31;11965
19/09/2017;11520;12560;11;42;11;20;;31;11889
20/09/2017;11500;12510;10;41;12;19;;31;11891
21/09/2017;11470;12395;9;40;13;18;;31;11858
22/09/2017;11430;12185;8;39;14;17;;31;11771
25/09/2017;11380;11960;5;36;17;14;;31;11698
26/09/2017;11357;11640;4;35;18;13;;31;11521
27/09/2017;11315;11430;3;34;19;12;;31;11385
28/09/2017;11323;11170;2;33;20;11;;31;11224
29/09/2017;11013;11631;1;32;21;10;;31;11432
02/10/2017;11050;11670;29;59;7;37;;44;11149
03/10/2017;11410;12160;28;58;6;36;;42;11517
04/10/2017;11940;12870;27;57;5;35;;40;12056
05/10/2017;12215;12760;26;56;4;34;;38;12272
06/10/2017;12195;12640;25;55;3;33;;36;12232
09/10/2017;12000;12260;22;52;0;30;;30;12000
10/10/2017;12230;12460;21;51;1;29;;30;12238
11/10/2017;12610;12870;20;50;2;28;;30;12627
12/10/2017;12630;13090;19;49;3;27;;30;12676
13/10/2017;12860;13410;18;48;4;26;;30;12933
16/10/2017;12825;13750;15;45;7;23;;30;13041
17/10/2017;12395;13045;14;44;8;22;;30;12568
18/10/2017;12380;13090;13;43;9;21;;30;12593
19/10/2017;12520;13530;12;42;10;20;;30;12857
20/10/2017;12355;13220;11;41;11;19;;30;12672
23/10/2017;12370;13280;8;38;14;16;;30;12795
24/10/2017;12320;12960;7;37;15;15;;30;12640
25/10/2017;12245;12520;6;36;16;14;;30;12392
26/10/2017;12215;12620;5;35;17;13;;30;12445
27/10/2017;12230;12730;4;34;18;12;;30;12530
30/10/2017;12210;12975;1;31;21;9;;30;12746
31/10/2017;12905;12510;0;30;22;8;;30;12615
01/11/2017;12990;12690;29;60;7;38;;45;12943
02/11/2017;13120;12820;28;59;6;37;;43;13078
03/11/2017;12960;12580;27;58;5;36;;41;12914
06/11/2017;12730;12380;24;55;2;33;;35;12710
07/11/2017;12390;12090;23;54;1;32;;33;12381
08/11/2017;11720;11390;22;53;0;31;;31;11720
09/11/2017;11420;11070;21;52;1;30;;31;11409
10/11/2017;11210;10885;20;51;2;29;;31;11189
13/11/2017;11305;10990;17;48;5;26;;31;11254
14/11/2017;11090;10610;16;47;6;25;;31;10997
15/11/2017;10995;10430;15;46;7;24;;31;10867
16/11/2017;11125;10535;14;45;8;23;;31;10973
17/11/2017;11260;10805;13;44;9;22;;31;11128
20/11/2017;11285;10965;10;41;12;19;;31;11161
21/11/2017;11120;10615;9;40;13;18;;31;10908
22/11/2017;11100;10645;8;39;14;17;;31;10895
23/11/2017;11135;10990;7;38;15;16;;31;11065
24/11/2017;11150;11145;6;37;16;15;;31;11147
27/11/2017;11150;11225;3;34;19;12;;31;11196
28/11/2017;11130;11785;2;33;20;11;;31;11553
29/11/2017;11135;12155;1;32;21;10;;31;11826
30/11/2017;12645;11450;0;31;22;9;;31;11797
01/12/2017;13280;12075;30;61;8;39;;47;13075
04/12/2017;12755;11530;27;58;5;36;;41;12606
05/12/2017;12200;10810;26;57;4;35;;39;12057
06/12/2017;12590;11190;25;56;3;34;;37;12476
07/12/2017;12720;11215;24;55;2;33;;35;12634
08/12/2017;13085;11675;23;54;1;32;;33;13042
11/12/2017;13270;12220;20;51;2;29;;31;13202
12/12/2017;13285;12125;19;50;3;28;;31;13173
13/12/2017;13165;11805;18;49;4;27;;31;12990
14/12/2017;12875;11210;17;48;5;26;;31;12606
15/12/2017;12855;11245;16;47;6;25;;31;12543
18/12/2017;12875;11380;13;44;9;22;;31;12441
19/12/2017;12870;11460;12;43;10;21;;31;12415
20/12/2017;12830;11140;11;42;11;20;;31;12230
21/12/2017;12830;11245;10;41;12;19;;31;12216
22/12/2017;11055;10250;9;40;13;18;;31;10717
27/12/2017;11240;10340;4;35;18;13;;31;10717
28/12/2017;11210;10410;3;34;19;12;;31;10720
29/12/2017;11110;10430;2;33;20;11;;31;10671
02/01/2018;11045;10445;29;57;7;35;;42;10945
03/01/2018;11455;11160;28;56;6;34;;40;11411
04/01/2018;11965;12030;27;55;5;33;;38;11974
05/01/2018;11810;11690;26;54;4;32;;36;11797
08/01/2018;11680;11530;23;51;1;29;;30;11675
09/01/2018;11170;10855;22;50;0;28;;28;11170
10/01/2018;10960;10910;21;49;1;27;;28;10958
11/01/2018;10725;10765;20;48;2;26;;28;10728
12/01/2018;10710;10880;19;47;3;25;;28;10728
15/01/2018;10790;11260;16;44;6;22;;28;10891
16/01/2018;10690;10965;15;43;7;21;;28;10759
17/01/2018;10680;10960;14;42;8;20;;28;10760
18/01/2018;10750;11090;13;41;9;19;;28;10859
19/01/2018;10920;11775;12;40;10;18;;28;11225
22/01/2018;10985;11880;9;37;13;15;;28;11401
23/01/2018;11020;12110;8;36;14;14;;28;11565
24/01/2018;11025;12040;7;35;15;13;;28;11569
25/01/2018;11075;11638;6;34;16;12;;28;11397
26/01/2018;11070;11580;5;33;17;11;;28;11380
29/01/2018;11110;11570;2;30;20;8;;28;11439
30/01/2018;11085;11230;1;29;21;7;;28;11194
31/01/2018;11060;12330;0;28;22;6;;28;12058
01/02/2018;11070;12350;27;58;5;36;;41;11226
02/02/2018;11300;12840;26;57;4;35;;39;11458
05/02/2018;11060;12580;23;54;1;32;;33;11106
06/02/2018;10730;12330;22;53;0;31;;31;10730
07/02/2018;10555;12210;21;52;1;30;;31;10608
08/02/2018;10430;11990;20;51;2;29;;31;10531
09/02/2018;10595;12435;19;50;3;28;;31;10773
12/02/2018;10385;12120;16;47;6;25;;31;10721
13/02/2018;10440;12300;15;46;7;24;;31;10860
14/02/2018;10515;12720;14;45;8;23;;31;11084
15/02/2018;10585;12835;13;44;9;22;;31;11238
16/02/2018;10615;13010;12;43;10;21;;31;11388
19/02/2018;10610;12960;9;40;13;18;;31;11595
20/02/2018;10610;12860;8;39;14;17;;31;11626
21/02/2018;10680;13215;7;38;15;16;;31;11907
22/02/2018;10710;13310;6;37;16;15;;31;12052
23/02/2018;10740;13130;5;36;17;14;;31;12051
26/02/2018;10750;13040;2;33;20;11;;31;12227
27/02/2018;10750;12700;1;32;21;10;;31;12071
28/02/2018;12690;13820;0;31;22;9;;31;13492
01/03/2018;12660;13930;30;60;8;38;;46;12881
02/03/2018;12630;13810;29;59;7;37;;44;12818
05/03/2018;12485;13490;26;56;4;34;;38;12591
06/03/2018;12910;14015;25;55;3;33;;36;13002
07/03/2018;13100;14060;24;54;2;32;;34;13156
08/03/2018;13180;14170;23;53;1;31;;32;13211
09/03/2018;13250;14210;22;52;0;30;;30;13250
12/03/2018;12920;13865;19;49;3;27;;30;13015
13/03/2018;12775;13660;18;48;4;26;;30;12893
14/03/2018;12760;13675;17;47;5;25;;30;12913
15/03/2018;12830;13810;16;46;6;24;;30;13026
16/03/2018;12810;13970;15;45;7;23;;30;13081
19/03/2018;12915;14180;12;42;10;20;;30;13337
20/03/2018;12875;13940;11;41;11;19;;30;13266
21/03/2018;12800;13755;10;40;12;18;;30;13182
22/03/2018;12780;13640;9;39;13;17;;30;13153
23/03/2018;12740;13485;8;38;14;16;;30;13088
26/03/2018;12655;13280;5;35;17;13;;30;13009
27/03/2018;12640;12800;4;34;18;12;;30;12736
28/03/2018;12630;12665;3;33;19;11;;30;12652
29/03/2018;12520;12825;2;32;20;10;;30;12723
03/04/2018;11670;12140;27;58;5;36;;41;11727
04/04/2018;10700;11430;26;57;4;35;;39;10775
05/04/2018;10980;11950;25;56;3;34;;37;11059
06/04/2018;11130;12190;24;55;2;33;;35;11191
09/04/2018;11490;12635;21;52;1;30;;31;11527
10/04/2018;11485;12755;20;51;2;29;;31;11567
11/04/2018;11325;12400;19;50;3;28;;31;11429
12/04/2018;11375;12715;18;49;4;27;;31;11548
13/04/2018;11260;12555;17;48;5;26;;31;11469
16/04/2018;10930;12080;14;45;8;23;;31;11227
17/04/2018;10820;11640;13;44;9;22;;31;11058
18/04/2018;10680;11490;12;43;10;21;;31;10941
19/04/2018;10625;11460;11;42;11;20;;31;10921
20/04/2018;10705;11580;10;41;12;19;;31;11044
23/04/2018;10625;11300;7;38;15;16;;31;10952
24/04/2018;10590;11325;6;37;16;15;;31;10969
25/04/2018;10540;10900;5;36;17;14;;31;10737
26/04/2018;10520;10815;4;35;18;13;;31;10691
27/04/2018;10535;10865;3;34;19;12;;31;10737
30/04/2018;10870;11600;0;31;22;9;;31;11388
01/05/2018;10820;11460;30;60;8;38;;46;10931
02/05/2018;10840;11655;29;59;7;37;;44;10970
03/05/2018;10735;11750;28;58;6;36;;42;10880
04/05/2018;10565;11585;27;57;5;35;;40;10693
08/05/2018;10420;11470;23;53;1;31;;32;10453
09/05/2018;10495;11655;22;52;0;30;;30;10495
10/05/2018;10535;11665;21;51;1;29;;30;10573
11/05/2018;10570;11720;20;50;2;28;;30;10647
14/05/2018;10320;11455;17;47;5;25;;30;10509
15/05/2018;10295;11390;16;46;6;24;;30;10514
16/05/2018;10285;11445;15;45;7;23;;30;10556
17/05/2018;10250;11420;14;44;8;22;;30;10562
18/05/2018;10290;11560;13;43;9;21;;30;10671
21/05/2018;10270;11530;10;40;12;18;;30;10774
22/05/2018;10225;11325;9;39;13;17;;30;10702
23/05/2018;10085;10615;8;38;14;16;;30;10332
24/05/2018;9965;10315;7;37;15;15;;30;10140
25/05/2018;9985;10255;6;36;16;14;;30;10129
29/05/2018;9895;10000;2;32;20;10;;30;9965
30/05/2018;9910;9900;1;31;21;9;;30;9903
31/05/2018;10570;11940;0;30;22;8;;30;11575
01/06/2018;10825;12345;29;60;7;38;;45;11061
04/06/2018;10795;12270;26;57;4;35;;39;10946
05/06/2018;11030;12375;25;56;3;34;;37;11139
06/06/2018;11245;12450;24;55;2;33;;35;11314
07/06/2018;11345;12395;23;54;1;32;;33;11377
08/06/2018;11420;12450;22;53;0;31;;31;11420
11/06/2018;11600;12560;19;50;3;28;;31;11693
12/06/2018;11480;12370;18;49;4;27;;31;11595
13/06/2018;11600;12565;17;48;5;26;;31;11756
14/06/2018;11530;12475;16;47;6;25;;31;11713
15/06/2018;11370;12300;15;46;7;24;;31;11580
18/06/2018;11270;11970;12;43;10;21;;31;11496
19/06/2018;11180;11690;11;42;11;20;;31;11361
20/06/2018;11150;11430;10;41;12;19;;31;11258
21/06/2018;11120;11345;9;40;13;18;;31;11214
22/06/2018;11120;11385;8;39;14;17;;31;11240
25/06/2018;11110;11405;5;36;17;14;;31;11272
26/06/2018;11085;11255;4;35;18;13;;31;11184
27/06/2018;11090;11710;3;34;19;12;;31;11470
28/06/2018;11090;11640;2;33;20;11;;31;11445
29/06/2018;11610;12275;1;32;21;10;;31;12060
02/07/2018;11255;11795;29;60;7;38;;45;11339
03/07/2018;11400;11810;28;59;6;37;;43;11457
04/07/2018;11520;12020;27;58;5;36;;41;11581
05/07/2018;11490;12065;26;57;4;35;;39;11549
06/07/2018;11265;11740;25;56;3;34;;37;11304
09/07/2018;11500;12080;22;53;0;31;;31;11500
10/07/2018;11950;12620;21;52;1;30;;31;11972
11/07/2018;11875;12405;20;51;2;29;;31;11909
12/07/2018;11720;12220;19;50;3;28;;31;11768
13/07/2018;11740;12240;18;49;4;27;;31;11805
16/07/2018;11725;12070;15;46;7;24;;31;11803
17/07/2018;11640;11930;14;45;8;23;;31;11715
18/07/2018;11595;11940;13;44;9;22;;31;11695
19/07/2018;11765;12070;12;43;10;21;;31;11863
20/07/2018;11810;12360;11;42;11;20;;31;12005
23/07/2018;11880;12595;8;39;14;17;;31;12203
24/07/2018;11860;12425;7;38;15;16;;31;12133
25/07/2018;11870;12380;6;37;16;15;;31;12133
26/07/2018;11850;12150;5;36;17;14;;31;12015
27/07/2018;11850;12245;4;35;18;13;;31;12079
30/07/2018;11920;12320;1;32;21;10;;31;12191
31/07/2018;12380;12580;0;31;22;9;;31;12522
01/08/2018;11870;12150;30;60;8;38;;46;11919
02/08/2018;11760;12055;29;59;7;37;;44;11807
03/08/2018;11615;11975;28;58;6;36;;42;11666
06/08/2018;11610;12110;25;55;3;33;;36;11652
07/08/2018;11430;11850;24;54;2;32;;34;11455
08/08/2018;11480;11960;23;53;1;31;;32;11495
09/08/2018;11510;12025;22;52;0;30;;30;11510
10/08/2018;11510;12140;21;51;1;29;;30;11531
13/08/2018;11510;12145;18;48;4;26;;30;11595
14/08/2018;11525;12345;17;47;5;25;;30;11662
15/08/2018;11635;12495;16;46;6;24;;30;11807
16/08/2018;11650;12385;15;45;7;23;;30;11822
17/08/2018;11735;12430;14;44;8;22;;30;11920
20/08/2018;11790;12530;11;41;11;19;;30;12061
21/08/2018;11810;12710;10;40;12;18;;30;12170
22/08/2018;11815;12655;9;39;13;17;;30;12179
23/08/2018;11865;12700;8;38;14;16;;30;12255
24/08/2018;11860;12560;7;37;15;15;;30;12210
28/08/2018;11865;12350;3;33;19;11;;30;12172
29/08/2018;11865;12220;2;32;20;10;;30;12102
30/08/2018;11875;12040;1;31;21;9;;30;11991
31/08/2018;11825;12355;0;30;22;8;;30;12214
03/09/2018;11863;12375;27;58;5;36;;41;11925
04/09/2018;11967;12433;26;57;4;35;;39;12015
05/09/2018;12008;12458;25;56;3;34;;37;12044
06/09/2018;12338;12796;24;55;2;33;;35;12364
07/09/2018;12429;12792;23;54;1;32;;33;12440
10/09/2018;12379;12683;20;51;2;29;;31;12399
11/09/2018;12242;12388;19;50;3;28;;31;12256
12/09/2018;12217;12304;18;49;4;27;;31;12228
13/09/2018;12317;12458;17;48;5;26;;31;12340
14/09/2018;12308;12458;16;47;6;25;;31;12337
17/09/2018;12175;12346;13;44;9;22;;31;12225
18/09/2018;12371;12571;12;43;10;21;;31;12436
19/09/2018;12342;12429;11;42;11;20;;31;12373
20/09/2018;12425;12583;10;41;12;19;;31;12486
21/09/2018;12433;12700;9;40;13;18;;31;12545
24/09/2018;12440;12735;6;37;16;15;;31;12592
25/09/2018;12448;12858;5;36;17;14;;31;12673
26/09/2018;12504;13083;4;35;18;13;;31;12840
27/09/2018;12504;13054;3;34;19;12;;31;12841
28/09/2018;12804;12604;2;33;20;11;;31;12675
01/10/2018;12713;12475;30;60;8;38;;46;12672
02/10/2018;12979;12650;29;59;7;37;;44;12927
03/10/2018;13121;12883;28;58;6;36;;42;13087
04/10/2018;13442;13104;27;57;5;35;;40;13400
05/10/2018;13550;13092;26;56;4;34;;38;13502
08/10/2018;13558;13071;23;53;1;31;;32;13543
09/10/2018;13400;12850;22;52;0;30;;30;13400
10/10/2018;13679;13158;21;51;1;29;;30;13662
11/10/2018;14079;13504;20;50;2;28;;30;14041
12/10/2018;14083;13583;19;49;3;27;;30;14033
15/10/2018;14058;13558;16;46;6;24;;30;13958
16/10/2018;13946;13321;15;45;7;23;;30;13800
17/10/2018;14075;13625;14;44;8;22;;30;13955
18/10/2018;13950;13271;13;43;9;21;;30;13746
19/10/2018;13941;13145;12;42;10;20;;30;13676
22/10/2018;13888;13004;9;39;13;17;;30;13505
23/10/2018;13804;12767;8;38;14;16;;30;13320
24/10/2018;13771;12613;7;37;15;15;;30;13192
25/10/2018;13654;12392;6;36;16;14;;30;12981
26/10/2018;13654;12363;5;35;17;13;;30;12922
29/10/2018;13638;12208;2;32;20;10;;30;12685
30/10/2018;13658;12367;1;31;21;9;;30;12754
31/10/2018;12600;12508;0;30;22;8;;30;12533
01/11/2018;12579;12500;29;60;7;38;;45;12567
02/11/2018;12617;12658;28;59;6;37;;43;12623
05/11/2018;12400;12404;25;56;3;34;;37;12400
06/11/2018;11958;11942;24;55;2;33;;35;11957
07/11/2018;11800;11771;23;54;1;32;;33;11799
08/11/2018;11671;11538;22;53;0;31;;31;11671
09/11/2018;11767;11604;21;52;1;30;;31;11762
12/11/2018;11942;11667;18;49;4;27;;31;11907
13/11/2018;11846;11358;17;48;5;26;;31;11767
14/11/2018;11454;10146;16;47;6;25;;31;11201
15/11/2018;11558;10383;15;46;7;24;;31;11293
16/11/2018;11571;10442;14;45;8;23;;31;11280
19/11/2018;11500;10317;11;42;11;20;;31;11080
20/11/2018;11417;10108;10;41;12;19;;31;10910
21/11/2018;11467;10388;9;40;13;18;;31;11015
22/11/2018;11525;10617;8;39;14;17;;31;11115
23/11/2018;11600;10938;7;38;15;16;;31;11280
26/11/2018;11646;11354;4;35;18;13;;31;11476
27/11/2018;11629;11575;3;34;19;12;;31;11596
28/11/2018;11646;11313;2;33;20;11;;31;11431
29/11/2018;11653;11263;1;32;21;10;;31;11389
30/11/2018;11525;10571;0;31;22;9;;31;10848
03/12/2018;12121;11550;28;59;6;37;;43;12041
04/12/2018;12033;11558;27;58;5;36;;41;11975
05/12/2018;11875;11600;26;57;4;35;;39;11847
06/12/2018;11742;11383;25;56;3;34;;37;11713
07/12/2018;11875;11350;24;55;2;33;;35;11845
10/12/2018;11729;11323;21;52;1;30;;31;11716
11/12/2018;11532;11245;20;51;2;29;;31;11513
12/12/2018;11795;11858;19;50;3;28;;31;11801
13/12/2018;11833;11983;18;49;4;27;;31;11852
14/12/2018;11783;11850;17;48;5;26;;31;11794
17/12/2018;11808;11833;14;45;8;23;;31;11814
18/12/2018;11808;11608;13;44;9;22;;31;11750
19/12/2018;11788;11504;12;43;10;21;;31;11696
20/12/2018;11746;11158;11;42;11;20;;31;11537
21/12/2018;11754;11063;10;41;12;19;;31;11487
24/12/2018;11069;11320;7;38;15;16;;31;11190
27/12/2018;11161;11420;4;35;18;13;;31;11311
28/12/2018;11258;11496;3;34;19;12;;31;11404
31/12/2018;11346;11592;0;31;22;9;;31;11521
02/01/2019;11075;11333;29;57;7;35;;42;11118
03/01/2019;10642;10925;28;56;6;34;;40;10684
04/01/2019;10392;10625;27;55;5;33;;38;10423
07/01/2019;10296;10663;24;52;2;30;;32;10319
08/01/2019;10100;10625;23;51;1;29;;30;10118
09/01/2019;9883;10379;22;50;0;28;;28;9883
10/01/2019;9575;10033;21;49;1;27;;28;9591
11/01/2019;9621;10233;20;48;2;26;;28;9665
14/01/2019;9542;10100;17;45;5;23;;28;9642
15/01/2019;9571;10125;16;44;6;22;;28;9690
16/01/2019;9263;9563;15;43;7;21;;28;9338
17/01/2019;9167;9304;14;42;8;20;;28;9206
18/01/2019;9000;8971;13;41;9;19;;28;8991
21/01/2019;8825;8667;10;38;12;16;;28;8757
22/01/2019;8708;8383;9;37;13;15;;28;8557
23/01/2019;8613;8017;8;36;14;14;;28;8315
24/01/2019;8433;7300;7;35;15;13;;28;7826
25/01/2019;8367;7108;6;34;16;12;;28;7648
28/01/2019;8208;6775;3;31;19;9;;28;7236
29/01/2019;8117;6354;2;30;20;8;;28;6858
30/01/2019;8168;6463;1;29;21;7;;28;6889
31/01/2019;6175;8113;0;28;22;6;;28;7698
01/02/2019;6375;8575;27;58;5;36;;41;6643
04/02/2019;6071;8379;24;55;2;33;;35;6203
05/02/2019;5950;8029;23;54;1;32;;33;6013
06/02/2019;5683;7608;22;53;0;31;;31;5683
07/02/2019;5533;7458;21;52;1;30;;31;5595
08/02/2019;5813;7833;20;51;2;29;;31;5943
11/02/2019;5758;7996;17;48;5;26;;31;6119
12/02/2019;5850;8346;16;47;6;25;;31;6333
13/02/2019;5283;7800;15;46;7;24;;31;5851
14/02/2019;5100;7350;14;45;8;23;;31;5681
15/02/2019;5133;7117;13;44;9;22;;31;5709
18/02/2019;5071;6904;10;41;12;19;;31;5781
19/02/2019;5146;7204;9;40;13;18;;31;6009
20/02/2019;5104;7104;8;39;14;17;;31;6007
21/02/2019;5071;7092;7;38;15;16;;31;6049
22/02/2019;5088;7154;6;37;16;15;;31;6154
25/02/2019;5094;7421;3;34;19;12;;31;6520
26/02/2019;5138;7725;2;33;20;11;;31;6807
27/02/2019;5138;8188;1;32;21;10;;31;7204
28/02/2019;8279;9738;0;31;22;9;;31;9314
01/03/2019;8213;9475;30;60;8;38;;46;8432
04/03/2019;8325;9675;27;57;5;35;;40;8494
05/03/2019;7975;9183;26;56;4;34;;38;8102
06/03/2019;7679;8600;25;55;3;33;;36;7756
07/03/2019;7275;8296;24;54;2;32;;34;7335
08/03/2019;7083;8113;23;53;1;31;;32;7115
11/03/2019;6988;7896;20;50;2;28;;30;7049
12/03/2019;7021;7892;19;49;3;27;;30;7108
13/03/2019;7033;8088;18;48;4;26;;30;7174
14/03/2019;7550;8858;17;47;5;25;;30;7768
15/03/2019;7763;9058;16;46;6;24;;30;8022
18/03/2019;7521;8646;13;43;9;21;;30;7859
19/03/2019;7521;8758;12;42;10;20;;30;7933
20/03/2019;7592;9229;11;41;11;19;;30;8192
21/03/2019;7600;9096;10;40;12;18;;30;8198
22/03/2019;7592;8954;9;39;13;17;;30;8182
25/03/2019;7563;8842;6;36;16;14;;30;8245
26/03/2019;7525;8613;5;35;17;13;;30;8142
27/03/2019;7546;8625;4;34;18;12;;30;8193
28/03/2019;7571;9088;3;33;19;11;;30;8532
29/03/2019;8767;9058;2;32;20;10;;30;8961
01/04/2019;8846;9092;29;60;7;38;;45;8884
02/04/2019;9113;9283;28;59;6;37;;43;9137
03/04/2019;8896;9063;27;58;5;36;;41;8916
04/04/2019;8608;8738;26;57;4;35;;39;8621
05/04/2019;8604;8750;25;56;3;34;;37;8616
08/04/2019;8717;8783;22;53;0;31;;31;8717
09/04/2019;8575;8763;21;52;1;30;;31;8581
10/04/2019;8546;8617;20;51;2;29;;31;8551
11/04/2019;8565;8595;19;50;3;28;;31;8568
12/04/2019;8942;9188;18;49;4;27;;31;8974
15/04/2019;8963;9363;15;46;7;24;;31;9053
16/04/2019;9042;9500;14;45;8;23;;31;9160
17/04/2019;9042;9446;13;44;9;22;;31;9159
18/04/2019;9088;9338;12;43;10;21;;31;9169
23/04/2019;9088;9404;7;38;15;16;;31;9241
24/04/2019;9058;9550;6;37;16;15;;31;9312
25/04/2019;9075;9625;5;36;17;14;;31;9377
26/04/2019;9046;9496;4;35;18;13;;31;9307
29/04/2019;9046;9550;1;32;21;10;;31;9387
30/04/2019;9538;9629;0;31;22;9;;31;9603
01/05/2019;9492;9604;30;60;8;38;;46;9511
02/05/2019;9533;9638;29;59;7;37;;44;9550
03/05/2019;9596;9683;28;58;6;36;;42;9608
07/05/2019;9438;9517;24;54;2;32;;34;9443
08/05/2019;9625;9650;23;53;1;31;;32;9626
09/05/2019;9546;9533;22;52;0;30;;30;9546
10/05/2019;9804;9817;21;51;1;29;;30;9804
13/05/2019;9879;10000;18;48;4;26;;30;9895
14/05/2019;10017;10342;17;47;5;25;;30;10071
15/05/2019;9925;10150;16;46;6;24;;30;9970
16/05/2019;9875;9967;15;45;7;23;;30;9896
17/05/2019;9838;9863;14;44;8;22;;30;9845
20/05/2019;9850;9988;11;41;11;19;;30;9901
21/05/2019;9904;10288;10;40;12;18;;30;10058
22/05/2019;9975;10558;9;39;13;17;;30;10228
23/05/2019;9992;10917;8;38;14;16;;30;10424
24/05/2019;10008;11167;7;37;15;15;;30;10588
28/05/2019;10042;11388;3;33;19;11;;30;10894
29/05/2019;10000;10888;2;32;20;10;;30;10592
30/05/2019;10013;10563;1;31;21;9;;30;10398
31/05/2019;10533;10579;0;30;22;8;;30;10567
03/06/2019;10463;10583;27;58;5;36;;41;10478
04/06/2019;10229;10338;26;57;4;35;;39;10240
05/06/2019;10063;10054;25;56;3;34;;37;10062
06/06/2019;10038;10163;24;55;2;33;;35;10045
07/06/2019;9979;10158;23;54;1;32;;33;9984
10/06/2019;9858;10050;20;51;2;29;;31;9870
11/06/2019;9704;10117;19;50;3;28;;31;9744
12/06/2019;9583;9925;18;49;4;27;;31;9627
13/06/2019;9504;9938;17;48;5;26;;31;9574
14/06/2019;9613;10113;16;47;6;25;;31;9710
17/06/2019;9529;9904;13;44;9;22;;31;9638
18/06/2019;9471;9871;12;43;10;21;;31;9600
19/06/2019;9433;9733;11;42;11;20;;31;9539
20/06/2019;9379;9617;10;41;12;19;;31;9471
21/06/2019;9375;9796;9;40;13;18;;31;9552
24/06/2019;9413;10308;6;37;16;15;;31;9875
25/06/2019;9446;10492;5;36;17;14;;31;10020
26/06/2019;9463;10604;4;35;18;13;;31;10126
27/06/2019;9463;10704;3;34;19;12;;31;10224
28/06/2019;10867;11063;2;33;20;11;;31;10993
01/07/2019;11213;11354;30;61;8;39;;47;11237
02/07/2019;11758;11758;29;60;7;38;;45;11758
03/07/2019;12454;12400;28;59;6;37;;43;12446
04/07/2019;13442;12779;27;58;5;36;;41;13361
05/07/2019;13408;12592;26;57;4;35;;39;13324
08/07/2019;13104;12179;23;54;1;32;;33;13076
09/07/2019;13917;13067;22;53;0;31;;31;13917
10/07/2019;13902;13108;21;52;1;30;;31;13876
11/07/2019;14338;13492;20;51;2;29;;31;14283
12/07/2019;14792;13913;19;50;3;28;;31;14707
15/07/2019;15033;14163;16;47;6;25;;31;14865
16/07/2019;14738;13713;15;46;7;24;;31;14507
17/07/2019;14979;14142;14;45;8;23;;31;14763
18/07/2019;15175;14465;13;44;9;22;;31;14969
19/07/2019;15417;14844;12;43;10;21;;31;15232
22/07/2019;15625;15621;9;40;13;18;;31;15623
23/07/2019;15296;14517;8;39;14;17;;31;14944
24/07/2019;15208;14108;7;38;15;16;;31;14676
25/07/2019;15267;14633;6;37;16;15;;31;14940
26/07/2019;15246;14138;5;36;17;14;;31;14638
29/07/2019;15196;13738;2;33;20;11;;31;14255
30/07/2019;15204;13192;1;32;21;10;;31;13841
31/07/2019;12963;12708;0;31;22;9;;31;12782
01/08/2019;13021;12679;30;60;8;38;;46;12962
02/08/2019;13000;12629;29;59;7;37;;44;12941
05/08/2019;13129;12450;26;56;4;34;;38;13058
06/08/2019;14379;13767;25;55;3;33;;36;14328
07/08/2019;14546;13513;24;54;2;32;;34;14485
08/08/2019;15113;13940;23;53;1;31;;32;15076
09/08/2019;15625;14767;22;52;0;30;;30;15625
12/08/2019;15696;15038;19;49;3;27;;30;15630
13/08/2019;16050;15575;18;48;4;26;;30;15987
14/08/2019;16171;15717;17;47;5;25;;30;16095
15/08/2019;16213;15796;16;46;6;24;;30;16130
16/08/2019;16225;15467;15;45;7;23;;30;16048
19/08/2019;16058;14771;12;42;10;20;;30;15629
20/08/2019;16104;15138;11;41;11;19;;30;15750
21/08/2019;16196;15663;10;40;12;18;;30;15983
22/08/2019;16292;16138;9;39;13;17;;30;16225
23/08/2019;16296;16433;8;38;14;16;;30;16360
27/08/2019;16329;16950;4;34;18;12;;30;16702
28/08/2019;16308;16675;3;33;19;11;;30;16540
29/08/2019;16311;16788;2;32;20;10;;30;16629
30/08/2019;17163;16079;1;31;21;9;;30;16404
02/09/2019;17067;16004;28;59;6;37;;43;16919
03/09/2019;16917;15483;27;58;5;36;;41;16742
04/09/2019;16871;15071;26;57;4;35;;39;16686
05/09/2019;16246;14304;25;56;3;34;;37;16089
06/09/2019;16567;14571;24;55;2;33;;35;16453
09/09/2019;16500;14629;21;52;1;30;;31;16440
10/09/2019;16383;14396;20;51;2;29;;31;16255
11/09/2019;16921;14929;19;50;3;28;;31;16728
12/09/2019;17463;15871;18;49;4;27;;31;17258
13/09/2019;17338;15733;17;48;5;26;;31;17079
16/09/2019;17254;15633;14;45;8;23;;31;16836
17/09/2019;16921;14871;13;44;9;22;;31;16326
18/09/2019;16758;14021;12;43;10;21;;31;15875
19/09/2019;16721;13763;11;42;11;20;;31;15671
20/09/2019;16754;13763;10;41;12;19;;31;15596
23/09/2019;16763;13929;7;38;15;16;;31;15392
24/09/2019;16750;13779;6;37;16;15;;31;15217
25/09/2019;16763;12988;5;36;17;14;;31;14693
26/09/2019;16696;12558;4;35;18;13;;31;14293
27/09/2019;16654;12392;3;34;19;12;;31;14042
30/09/2019;13079;12983;0;31;22;9;;31;13011
01/10/2019;13311;13146;30;60;8;38;;46;13282
02/10/2019;13629;13386;29;59;7;37;;44;13590
03/10/2019;13589;13332;28;58;6;36;;42;13552
04/10/2019;14086;13768;27;57;5;35;;40;14046
07/10/2019;14689;14486;24;54;2;32;;34;14677
08/10/2019;15325;15100;23;53;1;31;;32;15318
09/10/2019;15193;15089;22;52;0;30;;30;15193
10/10/2019;15096;14804;21;51;1;29;;30;15086
11/10/2019;15136;14771;20;50;2;28;;30;15112
14/10/2019;15100;14889;17;47;5;25;;30;15065
15/10/2019;14639;14152;16;46;6;24;;30;14542
16/10/2019;14304;13721;15;45;7;23;;30;14168
17/10/2019;14393;13811;14;44;8;22;;30;14238
18/10/2019;14461;13704;13;43;9;21;;30;14234
21/10/2019;14393;13332;10;40;12;18;;30;13969
22/10/2019;14386;13389;9;39;13;17;;30;13954
23/10/2019;14389;13239;8;38;14;16;;30;13852
24/10/2019;14404;13336;7;37;15;15;;30;13870
25/10/2019;14382;12796;6;36;16;14;;30;13536
28/10/2019;14343;12414;3;33;19;11;;30;13121
29/10/2019;14271;12393;2;32;20;10;;30;13019
30/10/2019;14257;11646;1;31;21;9;;30;12429
31/10/2019;11254;11246;0;30;22;8;;30;11248
01/11/2019;11414;11379;29;60;7;38;;45;11409
04/11/2019;11179;11132;26;57;4;35;;39;11174
05/11/2019;10929;10864;25;56;3;34;;37;10924
06/11/2019;10418;10168;24;55;2;33;;35;10404
07/11/2019;10139;9982;23;54;1;32;;33;10134
08/11/2019;10168;9971;22;53;0;31;;31;10168
11/11/2019;10182;9975;19;50;3;28;;31;10162
12/11/2019;9993;9818;18;49;4;27;;31;9970
13/11/2019;9841;9406;17;48;5;26;;31;9771
14/11/2019;9755;9063;16;47;6;25;;31;9621
15/11/2019;9884;9413;15;46;7;24;;31;9778
18/11/2019;9894;9597;12;43;10;21;;31;9798
19/11/2019;9900;9688;11;42;11;20;;31;9825
20/11/2019;9913;9691;10;41;12;19;;31;9827
21/11/2019;9894;9444;9;40;13;18;;31;9705
22/11/2019;9900;9650;8;39;14;17;;31;9787
25/11/2019;9891;9718;5;36;17;14;;31;9796
26/11/2019;9875;9981;4;35;18;13;;31;9937
27/11/2019;9884;10194;3;34;19;12;;31;10074
28/11/2019;9905;10363;2;33;20;11;;31;10200
29/11/2019;11094;10506;1;32;21;10;;31;10696
02/12/2019;11422;10441;29;60;7;38;;45;11269
03/12/2019;10688;9603;28;59;6;37;;43;10537
04/12/2019;10563;9466;27;58;5;36;;41;10429
05/12/2019;10678;9669;26;57;4;35;;39;10575
06/12/2019;11106;10038;25;56;3;34;;37;11019
09/12/2019;11081;10013;22;53;0;31;;31;11081
10/12/2019;11394;10400;21;52;1;30;;31;11362
11/12/2019;11363;10259;20;51;2;29;;31;11292
12/12/2019;11316;10153;19;50;3;28;;31;11203
13/12/2019;11297;10219;18;49;4;27;;31;11158
16/12/2019;11206;9900;15;46;7;24;;31;10911
17/12/2019;11019;9009;14;45;8;23;;31;10500
18/12/2019;10828;8675;13;44;9;22;;31;10203
19/12/2019;10669;8569;12;43;10;21;;31;9992
20/12/2019;10669;8659;11;42;11;20;;31;9956
23/12/2019;10675;8850;8;39;14;17;;31;9851
24/12/2019;8769;8788;7;38;15;16;;31;8778
27/12/2019;8669;8747;4;35;18;13;;31;8714
30/12/2019;8231;8622;1;32;21;10;;31;8496
31/12/2019;8231;8622;0;31;22;9;;31;8508
02/01/2020;7594;7675;29;58;7;36;;43;7607
03/01/2020;7119;7516;28;57;6;35;;41;7177
06/01/2020;6922;7356;25;54;3;32;;35;6959
07/01/2020;6722;7294;24;53;2;31;;33;6757
08/01/2020;6909;7575;23;52;1;30;;31;6930
09/01/2020;6859;7628;22;51;0;29;;29;6859
10/01/2020;6663;7638;21;50;1;28;;29;6697
13/01/2020;6375;7350;18;47;4;25;;29;6509
14/01/2020;6769;8150;17;46;5;24;;29;7007
15/01/2020;6972;8381;16;45;6;23;;29;7264
16/01/2020;6691;7838;15;44;7;22;;29;6968
17/01/2020;6544;7619;14;43;8;21;;29;6841
20/01/2020;6378;7378;11;40;11;18;;29;6757
21/01/2020;6278;7091;10;39;12;17;;29;6614
22/01/2020;6034;6525;9;38;13;16;;29;6254
23/01/2020;5856;6606;8;37;14;15;;29;6218
24/01/2020;5800;6572;7;36;15;14;;29;6199
27/01/2020;5738;5888;4;33;18;11;;29;5831
28/01/2020;5728;5834;3;32;19;10;;29;5797
29/01/2020;5672;5288;2;31;20;9;;29;5407
30/01/2020;5638;4922;1;30;21;8;;29;5120
31/01/2020;5000;7041;0;29;22;7;;29;6548
03/02/2020;4363;6669;26;57;4;35;;39;4600
04/02/2020;4447;6831;25;56;3;34;;37;4640
05/02/2020;4619;7322;24;55;2;33;;35;4773
06/02/2020;4447;6975;23;54;1;32;;33;4524
07/02/2020;4397;7006;22;53;0;31;;31;4397
10/02/2020;4069;6697;19;50;3;28;;31;4323
11/02/2020;4388;7288;18;49;4;27;;31;4762
12/02/2020;4503;7553;17;48;5;26;;31;4995
13/02/2020;4591;7503;16;47;6;25;;31;5155
14/02/2020;4619;7509;15;46;7;24;;31;5272
17/02/2020;4331;7050;12;43;10;21;;31;5208
18/02/2020;4453;7450;11;42;11;20;;31;5516
19/02/2020;4541;7756;10;41;12;19;;31;5786
20/02/2020;4556;7684;9;40;13;18;;31;5868
21/02/2020;4584;7859;8;39;14;17;;31;6063
24/02/2020;4581;7659;5;36;17;14;;31;6269
25/02/2020;4581;7669;4;35;18;13;;31;6374
26/02/2020;4588;7950;3;34;19;12;;31;6649
27/02/2020;4634;7997;2;33;20;11;;31;6804
28/02/2020;7825;9463;1;32;21;10;;31;8935
02/03/2020;7522;9016;29;59;7;37;;44;7760
03/03/2020;8038;9563;28;58;6;36;;42;8256
04/03/2020;8400;10050;27;57;5;35;;40;8606
05/03/2020;8866;10247;26;56;4;34;;38;9011
06/03/2020;8956;10097;25;55;3;33;;36;9051
09/03/2020;8100;9122;22;52;0;30;;30;8100
10/03/2020;8478;9559;21;51;1;29;;30;8514
11/03/2020;8075;9084;20;50;2;28;;30;8142
12/03/2020;7579;8197;19;49;3;27;;30;7641
13/03/2020;7369;7981;18;48;4;26;;30;7451
16/03/2020;7109;7094;15;45;7;23;;30;7106
17/03/2020;7072;6759;14;44;8;22;;30;6989
18/03/2020;6903;5944;13;43;9;21;;30;6615
19/03/2020;6838;6028;12;42;10;20;;30;6568
20/03/2020;6856;6084;11;41;11;19;;30;6573
23/03/2020;6791;5838;8;38;14;16;;30;6346
24/03/2020;6775;5547;7;37;15;15;;30;6161
25/03/2020;6747;5353;6;36;16;14;;30;6004
26/03/2020;6747;5681;5;35;17;13;;30;6143
27/03/2020;6765;5828;4;34;18;12;;30;6203
30/03/2020;6756;5675;1;31;21;9;;30;5999
31/03/2020;6553;7583;0;30;22;8;;30;7308
01/04/2020;6284;7250;29;60;7;38;;45;6434
02/04/2020;6297;7194;28;59;6;37;;43;6422
03/04/2020;6034;6941;27;58;5;36;;41;6145
06/04/2020;5763;6738;24;55;2;33;;35;5819
07/04/2020;6016;6997;23;54;1;32;;33;6046
08/04/2020;6356;7347;22;53;0;31;;31;6356
09/04/2020;6550;7938;21;52;1;30;;31;6595
14/04/2020;6316;7469;16;47;6;25;;31;6539
15/04/2020;6125;7300;15;46;7;24;;31;6390
16/04/2020;6034;7013;14;45;8;23;;31;6287
17/04/2020;6059;7044;13;44;9;22;;31;6345
20/04/2020;5950;6734;10;41;12;19;;31;6253
21/04/2020;5822;6031;9;40;13;18;;31;5910
22/04/2020;5809;5869;8;39;14;17;;31;5836
23/04/2020;5828;6016;7;38;15;16;;31;5919
24/04/2020;5797;5988;6;37;16;15;;31;5896
27/04/2020;5753;5931;3;34;19;12;;31;5862
28/04/2020;5725;5400;2;33;20;11;;31;5515
29/04/2020;5703;5272;1;32;21;10;;31;5411
30/04/2020;5284;6309;0;31;22;9;;31;6011
01/05/2020;5284;6275;30;60;8;38;;46;5456
04/05/2020;5241;6147;27;57;5;35;;40;5354
05/05/2020;5000;5800;26;56;4;34;;38;5084
06/05/2020;4831;5422;25;55;3;33;;36;4880
07/05/2020;4903;5531;24;54;2;32;;34;4940
11/05/2020;4800;5553;20;50;2;28;;30;4850
12/05/2020;4709;5400;19;49;3;27;;30;4778
13/05/2020;4516;5178;18;48;4;26;;30;4604
14/05/2020;4397;5153;17;47;5;25;;30;4523
15/05/2020;4356;5231;16;46;6;24;;30;4531
18/05/2020;4394;5553;13;43;9;21;;30;4742
19/05/2020;4356;5441;12;42;10;20;;30;4718
20/05/2020;4434;5988;11;41;11;19;;30;5004
21/05/2020;4466;6059;10;40;12;18;;30;5103
22/05/2020;4469;6138;9;39;13;17;;30;5192
26/05/2020;4509;6463;5;35;17;13;;30;5616
27/05/2020;4497;6303;4;34;18;12;;30;5581
28/05/2020;4497;6472;3;33;19;11;;30;5748
29/05/2020;6603;8119;2;32;20;10;;30;7614
01/06/2020;6525;8038;29;60;7;38;;45;6760
02/06/2020;6688;8241;28;59;6;37;;43;6905
03/06/2020;6463;8091;27;58;5;36;;41;6662
04/06/2020;6294;7866;26;57;4;35;;39;6455
05/06/2020;6297;7994;25;56;3;34;;37;6435
08/06/2020;6197;7794;22;53;0;31;;31;6197
09/06/2020;6069;7666;21;52;1;30;;31;6121
10/06/2020;6431;8359;20;51;2;29;;31;6555
11/06/2020;6697;8763;19;50;3;28;;31;6897
12/06/2020;6863;8994;18;49;4;27;;31;7138
15/06/2020;6991;9363;15;46;7;24;;31;7527
16/06/2020;7384;10750;14;45;8;23;;31;8253
17/06/2020;7491;11594;13;44;9;22;;31;8682
18/06/2020;7578;11284;12;43;10;21;;31;8773
19/06/2020;7547;11000;11;42;11;20;;31;8772
22/06/2020;7594;11338;8;39;14;17;;31;9285
23/06/2020;7631;11688;7;38;15;16;;31;9594
24/06/2020;7628;11063;6;37;16;15;;31;9401
25/06/2020;7638;10894;5;36;17;14;;31;9424
26/06/2020;7638;10950;4;35;18;13;;31;9561
29/06/2020;7634;11275;1;32;21;10;;31;10100
30/06/2020;10856;10766;0;31;22;9;;31;10792
01/07/2020;10622;10594;30;61;8;39;;47;10617
02/07/2020;11325;11397;29;60;7;38;;45;11336
03/07/2020;12594;12578;28;59;6;37;;43;12592
06/07/2020;13659;13725;25;56;3;34;;37;13664
07/07/2020;13288;13328;24;55;2;33;;35;13290
08/07/2020;13503;13503;23;54;1;32;;33;13503
09/07/2020;13331;13413;22;53;0;31;;31;13331
10/07/2020;13206;13209;21;52;1;30;;31;13206
13/07/2020;12941;12953;18;49;4;27;;31;12943
14/07/2020;12400;12356;17;48;5;26;;31;12393
15/07/2020;11884;11672;16;47;6;25;;31;11843
16/07/2020;11631;11397;15;46;7;24;;31;11578
17/07/2020;11538;11341;14;45;8;23;;31;11487
20/07/2020;11384;10697;11;42;11;20;;31;11140
21/07/2020;11281;10350;10;41;12;19;;31;10921
22/07/2020;11125;9625;9;40;13;18;;31;10496
23/07/2020;11006;9506;8;39;14;17;;31;10329
24/07/2020;11009;9606;7;38;15;16;;31;10330
27/07/2020;11047;9856;4;35;18;13;;31;10355
28/07/2020;11084;10556;3;34;19;12;;31;10760
29/07/2020;11094;11338;2;33;20;11;;31;11251
30/07/2020;11088;11328;1;32;21;10;;31;11251
31/07/2020;11644;12219;0;31;22;9;;31;12052
03/08/2020;11978;12638;28;58;6;36;;42;12072
04/08/2020;12397;13116;27;57;5;35;;40;12487
05/08/2020;12969;13672;26;56;4;34;;38;13043
06/08/2020;13041;13413;25;55;3;33;;36;13072
07/08/2020;13088;13244;24;54;2;32;;34;13097
10/08/2020;13591;13788;21;51;1;29;;30;13598
11/08/2020;14088;14281;20;50;2;28;;30;14101
12/08/2020;13988;14013;19;49;3;27;;30;13991
13/08/2020;13784;13591;18;48;4;26;;30;13758
14/08/2020;13553;13338;17;47;5;25;;30;13517
17/08/2020;13453;13213;14;44;8;22;;30;13389
18/08/2020;13388;13103;13;43;9;21;;30;13303
19/08/2020;13163;12759;12;42;10;20;;30;13028
20/08/2020;13050;12681;11;41;11;19;;30;12915
21/08/2020;13159;13394;10;40;12;18;;30;13253
24/08/2020;13250;13981;7;37;15;15;;30;13616
25/08/2020;13288;14091;6;36;16;14;;30;13716
26/08/2020;13288;14200;5;35;17;13;;30;13805
27/08/2020;13278;14041;4;34;18;12;;30;13736
28/08/2020;13797;13872;3;33;19;11;;30;13845
01/09/2020;12766;12956;29;60;7;38;;45;12796
02/09/2020;12172;12725;28;59;6;37;;43;12249
03/09/2020;11859;12409;27;58;5;36;;41;11926
04/09/2020;12094;12700;26;57;4;35;;39;12156
07/09/2020;12272;12909;23;54;1;32;;33;12291
08/09/2020;11878;12281;22;53;0;31;;31;11878
09/09/2020;11291;11703;21;52;1;30;;31;11304
10/09/2020;11403;12238;20;51;2;29;;31;11457
11/09/2020;11334;12178;19;50;3;28;;31;11416
14/09/2020;11391;12697;16;47;6;25;;31;11644
15/09/2020;11319;12441;15;46;7;24;;31;11572
16/09/2020;11259;12128;14;45;8;23;;31;11483
17/09/2020;11231;12359;13;44;9;22;;31;11558
18/09/2020;11244;12747;12;43;10;21;;31;11729
21/09/2020;11213;12300;9;40;13;18;;31;11669
22/09/2020;11156;12194;8;39;14;17;;31;11625
23/09/2020;11203;12566;7;38;15;16;;31;11863
24/09/2020;11178;12588;6;37;16;15;;31;11906
25/09/2020;11184;12606;5;36;17;14;;31;11964
28/09/2020;11163;12153;2;33;20;11;;31;11802
29/09/2020;11153;11931;1;32;21;10;;31;11680
30/09/2020;11703;12159;0;31;22;9;;31;12027
01/10/2020;11900;12303;30;60;8;38;;46;11970
02/10/2020;12672;12809;29;59;7;37;;44;12694
05/10/2020;12425;12609;26;56;4;34;;38;12444
06/10/2020;12316;12681;25;55;3;33;;36;12346
07/10/2020;11816;12184;24;54;2;32;;34;11838
08/10/2020;11950;12344;23;53;1;31;;32;11962
09/10/2020;11697;12163;22;52;0;30;;30;11697
12/10/2020;11691;12088;19;49;3;27;;30;11731
13/10/2020;11416;11719;18;48;4;26;;30;11456
14/10/2020;10944;10891;17;47;5;25;;30;10935
15/10/2020;10681;10575;16;46;6;24;;30;10660
16/10/2020;10700;10453;15;45;7;23;;30;10642
19/10/2020;10728;10553;12;42;10;20;;30;10670
20/10/2020;10725;10663;11;41;11;19;;30;10702
21/10/2020;10750;10966;10;40;12;18;;30;10836
22/10/2020;10750;11181;9;39;13;17;;30;10937
23/10/2020;10756;11353;8;38;14;16;;30;11035
26/10/2020;10775;10969;5;35;17;13;;30;10885
27/10/2020;10766;10681;4;34;18;12;;30;10715
28/10/2020;10750;10175;3;33;19;11;;30;10386
29/10/2020;10734;9956;2;32;20;10;;30;10215
30/10/2020;9925;9466;1;31;21;9;;30;9604
02/11/2020;9434;9231;28;59;6;37;;43;9406
03/11/2020;9369;9266;27;58;5;36;;41;9356
04/11/2020;9484;9313;26;57;4;35;;39;9466
05/11/2020;9513;9456;25;56;3;34;;37;9508
06/11/2020;9350;9469;24;55;2;33;;35;9357
09/11/2020;9541;9672;21;52;1;30;;31;9545
10/11/2020;9469;9578;20;51;2;29;;31;9476
11/11/2020;9319;9350;19;50;3;28;;31;9322
12/11/2020;9622;9641;18;49;4;27;;31;9624
13/11/2020;9744;9794;17;48;5;26;;31;9752
16/11/2020;9688;9725;14;45;8;23;;31;9698
17/11/2020;9994;10425;13;44;9;22;;31;10119
18/11/2020;10009;10456;12;43;10;21;;31;10153
19/11/2020;10056;10666;11;42;11;20;;31;10272
20/11/2020;10106;10628;10;41;12;19;;31;10308
23/11/2020;10141;10841;7;38;15;16;;31;10480
24/11/2020;10144;10672;6;37;16;15;;31;10417
25/11/2020;10156;10819;5;36;17;14;;31;10520
26/11/2020;10166;10719;4;35;18;13;;31;10487
27/11/2020;10154;10725;3;34;19;12;;31;10504
30/11/2020;10675;7922;0;31;22;9;;31;8721
01/12/2020;10409;7656;30;61;8;39;;47;9940
02/12/2020;10266;7597;29;60;7;38;;45;9851
03/12/2020;10444;8066;28;59;6;37;;43;10112
04/12/2020;10541;8400;27;58;5;36;;41;10280
07/12/2020;10697;8703;24;55;2;33;;35;10583
08/12/2020;11216;9119;23;54;1;32;;33;11152
09/12/2020;11309;9256;22;53;0;31;;31;11309
10/12/2020;11425;9334;21;52;1;30;;31;11358
11/12/2020;11550;9408;20;51;2;29;;31;11412
14/12/2020;11678;9863;17;48;5;26;;31;11385
15/12/2020;11434;9150;16;47;6;25;;31;10992
16/12/2020;11347;8963;15;46;7;24;;31;10809
17/12/2020;11275;9250;14;45;8;23;;31;10752
18/12/2020;11266;8981;13;44;9;22;;31;10603
21/12/2020;11256;8791;10;41;12;19;;31;10302
22/12/2020;11259;9038;9;40;13;18;;31;10328
23/12/2020;11256;9004;8;39;14;17;;31;10239
24/12/2020;8973;8106;7;38;15;16;;31;8553
29/12/2020;9144;8247;2;33;20;11;;31;8565
30/12/2020;9684;8866;1;32;21;10;;31;9130
31/12/2020;9719;8838;0;31;22;9;;31;9094
04/01/2021;10644;9581;27;55;5;33;;38;10504
05/01/2021;11391;9853;26;54;4;32;;36;11220
06/01/2021;11231;9494;25;53;3;31;;34;11078
07/01/2021;12344;10428;24;52;2;30;;32;12224
08/01/2021;12919;10909;23;51;1;29;;30;12852
11/01/2021;13922;12075;20;48;2;26;;28;13790
12/01/2021;12681;11019;19;47;3;25;;28;12503
13/01/2021;12006;10544;18;46;4;24;;28;11797
14/01/2021;12438;11313;17;45;5;23;;28;12237
15/01/2021;12913;11966;16;44;6;22;;28;12710
18/01/2021;12566;11500;13;41;9;19;;28;12223
19/01/2021;12656;11625;12;40;10;18;;28;12288
20/01/2021;12831;11863;11;39;11;17;;28;12451
21/01/2021;12963;12369;10;38;12;16;;28;12708
22/01/2021;12966;12166;9;37;13;15;;28;12595
25/01/2021;12944;12044;6;34;16;12;;28;12430
26/01/2021;12922;11372;5;33;17;11;;28;11981
27/01/2021;12947;12172;4;32;18;10;;28;12449
28/01/2021;12950;11903;3;31;19;9;;28;12240
29/01/2021;12359;12328;2;30;20;8;;28;12337
01/02/2021;12444;12400;27;58;5;36;;41;12439
02/02/2021;11928;11853;26;57;4;35;;39;11920
03/02/2021;12544;12419;25;56;3;34;;37;12534
04/02/2021;12719;12563;24;55;2;33;;35;12710
05/02/2021;13444;13288;23;54;1;32;;33;13439
08/02/2021;13391;13188;20;51;2;29;;31;13378
09/02/2021;14219;14113;19;50;3;28;;31;14209
10/02/2021;14588;14516;18;49;4;27;;31;14579
11/02/2021;15475;15475;17;48;5;26;;31;15475
12/02/2021;15916;16263;16;47;6;25;;31;15983
15/02/2021;15994;17131;13;44;9;22;;31;16324
16/02/2021;17266;21250;12;43;10;21;;31;18551
17/02/2021;18013;22313;11;42;11;20;;31;19539
18/02/2021;17100;17681;10;41;12;19;;31;17325
19/02/2021;16906;19716;9;40;13;18;;31;18084
22/02/2021;16850;18806;6;37;16;15;;31;17860
23/02/2021;16838;19222;5;36;17;14;;31;18145
24/02/2021;16763;17678;4;35;18;13;;31;17294
25/02/2021;16750;17031;3;34;19;12;;31;16922
26/02/2021;16947;16766;2;33;20;11;;31;16830
01/03/2021;16803;16722;30;60;8;38;;46;16789
02/03/2021;19759;19219;29;59;7;37;;44;19673
03/03/2021;19550;19847;28;58;6;36;;42;19592
04/03/2021;19647;20244;27;57;5;35;;40;19722
05/03/2021;19800;21044;26;56;4;34;;38;19931
08/03/2021;19794;21328;23;53;1;31;;32;19842
09/03/2021;19081;20213;22;52;0;30;;30;19081
10/03/2021;18450;18728;21;51;1;29;;30;18459
11/03/2021;18775;20000;20;50;2;28;;30;18857
12/03/2021;19038;20931;19;49;3;27;;30;19227
15/03/2021;19328;21641;16;46;6;24;;30;19791
16/03/2021;19994;22644;15;45;7;23;;30;20612
17/03/2021;21119;25078;14;44;8;22;;30;22175
18/03/2021;21769;27206;13;43;9;21;;30;23400
19/03/2021;22294;27163;12;42;10;20;;30;23917
22/03/2021;22281;26484;9;39;13;17;;30;24102
23/03/2021;21628;23078;8;38;14;16;;30;22305
24/03/2021;21447;22819;7;37;15;15;;30;22133
25/03/2021;21522;25928;6;36;16;14;;30;23872
26/03/2021;21456;25231;5;35;17;13;;30;23595
29/03/2021;21341;23103;2;32;20;10;;30;22516
30/03/2021;21319;21050;1;31;21;9;;30;21131
31/03/2021;20641;19744;0;30;22;8;;30;19983
01/04/2021;21091;20753;29;60;7;38;;45;21038
06/04/2021;19963;19875;24;55;2;33;;35;19958
07/04/2021;18475;18706;23;54;1;32;;33;18482
08/04/2021;17100;17100;22;53;0;31;;31;17100
09/04/2021;17029;17264;21;52;1;30;;31;17037
12/04/2021;17475;18229;18;49;4;27;;31;17572
13/04/2021;17457;18232;17;48;5;26;;31;17582
14/04/2021;18893;20921;16;47;6;25;;31;19286
15/04/2021;19557;22814;15;46;7;24;;31;20292
16/04/2021;19596;22539;14;45;8;23;;31;20355
19/04/2021;19864;23021;11;42;11;20;;31;20984
20/04/2021;20664;24457;10;41;12;19;;31;22132
21/04/2021;20957;24789;9;40;13;18;;31;22564
22/04/2021;20539;22157;8;39;14;17;;31;21270
23/04/2021;20514;22879;7;38;15;16;;31;21658
26/04/2021;20343;21446;4;35;18;13;;31;20983
27/04/2021;20493;23721;3;34;19;12;;31;22471
28/04/2021;20486;23814;2;33;20;11;;31;22633
29/04/2021;20536;24939;1;32;21;10;;31;23519
30/04/2021;24689;24704;0;31;22;9;;31;24700
04/05/2021;25911;26079;27;57;5;35;;40;25932
05/05/2021;25779;25864;26;56;4;34;;38;25788
06/05/2021;24429;24514;25;55;3;33;;36;24436
07/05/2021;26107;26300;24;54;2;32;;34;26118
10/05/2021;26457;27364;21;51;1;29;;30;26487
11/05/2021;25993;26407;20;50;2;28;;30;26021
12/05/2021;25286;25261;19;49;3;27;;30;25284
13/05/2021;24950;24786;18;48;4;26;;30;24928
14/05/2021;24814;24161;17;47;5;25;;30;24705
17/05/2021;24496;22779;14;44;8;22;;30;24038
18/05/2021;24664;24371;13;43;9;21;;30;24576
19/05/2021;25114;25693;12;42;10;20;;30;25307
20/05/2021;25114;25950;11;41;11;19;;30;25421
21/05/2021;25104;26129;10;40;12;18;;30;25514
24/05/2021;24950;24818;7;37;15;15;;30;24884
25/05/2021;24764;24186;6;36;16;14;;30;24456
26/05/2021;24696;23961;5;35;17;13;;30;24280
27/05/2021;24650;24368;4;34;18;12;;30;24481
28/05/2021;24346;25196;3;33;19;11;;30;24884
01/06/2021;24818;26050;29;60;7;38;;45;25010
02/06/2021;24929;25843;28;59;6;37;;43;25057
03/06/2021;25000;26146;27;58;5;36;;41;25140
04/06/2021;25907;27111;26;57;4;35;;39;26030
07/06/2021;25239;26311;23;54;1;32;;33;25271
08/06/2021;25829;27200;22;53;0;31;;31;25829
09/06/2021;27575;29550;21;52;1;30;;31;27639
10/06/2021;28400;31621;20;51;2;29;;31;28608
11/06/2021;28932;32750;19;50;3;28;;31;29301
14/06/2021;28421;31704;16;47;6;25;;31;29056
15/06/2021;29032;33796;15;46;7;24;;31;30108
16/06/2021;29507;35068;14;45;8;23;;31;30942
17/06/2021;28861;33079;13;44;9;22;;31;30086
18/06/2021;28782;32107;12;43;10;21;;31;29855
21/06/2021;28482;31632;9;40;13;18;;31;29803
22/06/2021;28232;31814;8;39;14;17;;31;29850
23/06/2021;28279;33446;7;38;15;16;;31;30779
24/06/2021;28343;34468;6;37;16;15;;31;31504
25/06/2021;28461;37036;5;36;17;14;;31;33163
28/06/2021;28482;35950;2;33;20;11;;31;33300
29/06/2021;28507;36089;1;32;21;10;;31;33643
30/06/2021;37639;37314;0;31;22;9;;31;37408
01/07/2021;36525;35336;30;61;8;39;;47;36323
02/07/2021;35357;34514;29;60;7;38;;45;35226
05/07/2021;32668;31454;26;57;4;35;;39;32543
06/07/2021;34036;33271;25;56;3;34;;37;33974
07/07/2021;35250;34982;24;55;2;33;;35;35235
08/07/2021;34675;33571;23;54;1;32;;33;34642
09/07/2021;35386;34304;22;53;0;31;;31;35386
12/07/2021;33907;31764;19;50;3;28;;31;33700
13/07/2021;33550;30779;18;49;4;27;;31;33192
14/07/2021;32261;28843;17;48;5;26;;31;31710
15/07/2021;33036;29904;16;47;6;25;;31;32430
16/07/2021;32929;30600;15;46;7;24;;31;32403
19/07/2021;33129;31807;12;43;10;21;;31;32703
20/07/2021;33150;31789;11;42;11;20;;31;32667
21/07/2021;33254;32725;10;41;12;19;;31;33049
22/07/2021;33204;32804;9;40;13;18;;31;33036
23/07/2021;33125;32514;8;39;14;17;;31;32849
26/07/2021;32918;30482;5;36;17;14;;31;31582
27/07/2021;32918;28996;4;35;18;13;;31;30641
28/07/2021;32914;28800;3;34;19;12;;31;30393
29/07/2021;32918;30607;2;33;20;11;;31;31427
30/07/2021;30050;31043;1;32;21;10;;31;30723
02/08/2021;31143;32411;29;59;7;37;;44;31345
03/08/2021;31507;33057;28;58;6;36;;42;31728
04/08/2021;31986;33882;27;57;5;35;;40;32223
05/08/2021;30904;32871;26;56;4;34;;38;31111
06/08/2021;30914;32446;25;55;3;33;;36;31042
09/08/2021;30139;31593;22;52;0;30;;30;30139
10/08/2021;31054;33039;21;51;1;29;;30;31120
11/08/2021;31900;34004;20;50;2;28;;30;32040
12/08/2021;31707;33729;19;49;3;27;;30;31909
13/08/2021;31500;33700;18;48;4;26;;30;31793
16/08/2021;31161;34250;15;45;7;23;;30;31882
17/08/2021;31279;35586;14;44;8;22;;30;32428
18/08/2021;31379;35793;13;43;9;21;;30;32703
19/08/2021;31257;35296;12;42;10;20;;30;32603
20/08/2021;31261;36100;11;41;11;19;;30;33035
23/08/2021;31332;36329;8;38;14;16;;30;33664
24/08/2021;31423;37114;7;37;15;15;;30;34269
25/08/2021;31304;35264;6;36;16;14;;30;33416
26/08/2021;31339;36457;5;35;17;13;;30;34239
27/08/2021;31332;34904;4;34;18;12;;30;33475
31/08/2021;33054;34214;0;30;22;8;;30;33905
01/09/2021;32568;33850;29;60;7;38;;45;32767
02/09/2021;31954;33736;28;59;6;37;;43;32203
03/09/2021;31686;33107;27;58;5;36;;41;31859
06/09/2021;30321;31446;24;55;2;33;;35;30385
07/09/2021;30889;32632;23;54;1;32;;33;30942
08/09/2021;31621;33861;22;53;0;31;;31;31621
09/09/2021;32471;35036;21;52;1;30;;31;32554
10/09/2021;32686;35457;20;51;2;29;;31;32865
13/09/2021;32725;35500;17;48;5;26;;31;33173
14/09/2021;32439;34032;16;47;6;25;;31;32747
15/09/2021;32686;35357;15;46;7;24;;31;33289
16/09/2021;33064;36225;14;45;8;23;;31;33880
17/09/2021;33225;36404;13;44;9;22;;31;34148
20/09/2021;32754;33800;10;41;12;19;;31;33159
21/09/2021;32979;36111;9;40;13;18;;31;34292
22/09/2021;32714;35246;8;39;14;17;;31;33857
23/09/2021;32793;35757;7;38;15;16;;31;34227
24/09/2021;32846;36311;6;37;16;15;;31;34634
27/09/2021;32918;36107;3;34;19;12;;31;34873
28/09/2021;32936;37989;2;33;20;11;;31;36196
29/09/2021;32918;36139;1;32;21;10;;31;35100
30/09/2021;36196;36500;0;31;22;9;;31;36412
01/10/2021;36621;37200;30;60;8;38;;46;36722
04/10/2021;36243;36996;27;57;5;35;;40;36337
05/10/2021;37168;39796;26;56;4;34;;38;37445
06/10/2021;36464;38411;25;55;3;33;;36;36626
07/10/2021;35518;37429;24;54;2;32;;34;35630
08/10/2021;35611;37964;23;53;1;31;;32;35685
11/10/2021;35825;39286;20;50;2;28;;30;36056
12/10/2021;35793;38500;19;49;3;27;;30;36064
13/10/2021;35711;38196;18;48;4;26;;30;36042
14/10/2021;35711;38518;17;47;5;25;;30;36179
15/10/2021;35421;37550;16;46;6;24;;30;35847
18/10/2021;35518;39107;13;43;9;21;;30;36595
19/10/2021;35629;39914;12;42;10;20;;30;37057
20/10/2021;35568;38911;11;41;11;19;;30;36794
21/10/2021;35354;38657;10;40;12;18;;30;36675
22/10/2021;35114;36961;9;39;13;17;;30;35914
25/10/2021;35279;35421;6;36;16;14;;30;35355
26/10/2021;35182;33068;5;35;17;13;;30;33984
27/10/2021;35093;33693;4;34;18;12;;30;34253
28/10/2021;35046;33754;3;33;19;11;;30;34228
29/10/2021;34379;32986;2;32;20;10;;30;33450
01/11/2021;30250;28964;29;60;7;38;;45;30050
02/11/2021;27307;24807;28;59;6;37;;43;26958
03/11/2021;24557;22321;27;58;5;36;;41;24284
04/11/2021;25854;24129;26;57;4;35;;39;25677
05/11/2021;25300;24221;25;56;3;34;;37;25213
08/11/2021;27264;25961;22;53;0;31;;31;27264
09/11/2021;26479;24886;21;52;1;30;;31;26428
10/11/2021;25179;22550;20;51;2;29;;31;25009
11/11/2021;24593;21304;19;50;3;28;;31;24275
12/11/2021;24750;21518;18;49;4;27;;31;24333
15/11/2021;24357;20664;15;46;7;24;;31;23523
16/11/2021;23843;18589;14;45;8;23;;31;22487
17/11/2021;23314;18604;13;44;9;22;;31;21947
18/11/2021;23293;19500;12;43;10;21;;31;22069
19/11/2021;23575;21607;11;42;11;20;;31;22877
22/11/2021;23725;21821;8;39;14;17;;31;22865
23/11/2021;23650;20336;7;38;15;16;;31;22046
24/11/2021;23886;23232;6;37;16;15;;31;23548
25/11/2021;24064;23286;5;36;17;14;;31;23637
26/11/2021;24086;22675;4;35;18;13;;31;23267
29/11/2021;24132;23650;1;32;21;10;;31;23805
30/11/2021;23750;22057;0;31;22;9;;31;22549
01/12/2021;26068;23689;30;61;8;39;;47;25663
02/12/2021;26579;24425;29;60;7;38;;45;26244
03/12/2021;28054;25732;28;59;6;37;;43;27730
06/12/2021;27289;25143;25;56;3;34;;37;27115
07/12/2021;26661;23986;24;55;2;33;;35;26508
08/12/2021;25546;22339;23;54;1;32;;33;25449
09/12/2021;25504;21943;22;53;0;31;;31;25504
10/12/2021;25321;22296;21;52;1;30;;31;25223
13/12/2021;25279;22361;18;49;4;27;;31;24902
14/12/2021;24568;20500;17;48;5;26;;31;23912
15/12/2021;24400;20386;16;47;6;25;;31;23623
16/12/2021;24168;20136;15;46;7;24;;31;23258
17/12/2021;23825;19593;14;45;8;23;;31;22733
20/12/2021;23839;20643;11;42;11;20;;31;22705
21/12/2021;23864;21946;10;41;12;19;;31;23122
22/12/2021;23946;22811;9;40;13;18;;31;23470
23/12/2021;24013;23321;8;39;14;17;;31;23700
24/12/2021;23675;23650;7;38;15;16;;31;23663
29/12/2021;25114;25207;2;33;20;11;;31;25174
30/12/2021;26011;26139;1;32;21;10;;31;26098
31/12/2021;25950;26143;0;31;22;9;;31;26087
04/01/2022;24336;24469;27;55;5;33;;38;24354
05/01/2022;24343;24243;26;54;4;32;;36;24332
06/01/2022;23189;23243;25;53;3;31;;34;23194
07/01/2022;23039;23500;24;52;2;30;;32;23068
10/01/2022;21901;21418;21;49;1;27;;28;21884
11/01/2022;21889;22264;20;48;2;26;;28;21916
12/01/2022;21254;21475;19;47;3;25;;28;21278
13/01/2022;20086;20236;18;46;4;24;;28;20107
14/01/2022;20589;20782;17;45;5;23;;28;20623
17/01/2022;20375;19711;14;42;8;20;;28;20185
18/01/2022;20100;17654;13;41;9;19;;28;19314
19/01/2022;19843;17011;12;40;10;18;;28;18832
20/01/2022;20164;19489;11;39;11;17;;28;19899
21/01/2022;20071;18064;10;38;12;16;;28;19211
24/01/2022;20143;19068;7;35;15;13;;28;19567
25/01/2022;19954;17686;6;34;16;12;;28;18658
26/01/2022;19886;16843;5;33;17;11;;28;18038
27/01/2022;19836;17607;4;32;18;10;;28;18403
28/01/2022;19861;18761;3;31;19;9;;28;19115
31/01/2022;17882;21889;0;28;22;6;;28;21030
01/02/2022;17218;21518;27;58;5;36;;41;17742
02/02/2022;17293;22143;26;57;4;35;;39;17790
03/02/2022;16829;21636;25;56;3;34;;37;17219
04/02/2022;17471;22975;24;55;2;33;;35;17786
07/02/2022;18021;24000;21;52;1;30;;31;18214
08/02/2022;18871;24832;20;51;2;29;;31;19256
09/02/2022;19364;25761;19;50;3;28;;31;19983
10/02/2022;20086;25857;18;49;4;27;;31;20831
11/02/2022;20057;25771;17;48;5;26;;31;20979
14/02/2022;19650;24057;14;45;8;23;;31;20787
15/02/2022;19204;24754;13;44;9;22;;31;20815
16/02/2022;18750;23814;12;43;10;21;;31;20384
17/02/2022;18636;24732;11;42;11;20;;31;20799
18/02/2022;18679;24829;10;41;12;19;;31;21060
21/02/2022;18793;25479;7;38;15;16;;31;22028
22/02/2022;18864;24950;6;37;16;15;;31;22005
23/02/2022;19014;26307;5;36;17;14;;31;23013
24/02/2022;18921;23654;4;35;18;13;;31;21669
25/02/2022;18911;24196;3;34;19;12;;31;22150
28/02/2022;22675;24904;0;31;22;9;;31;24257
01/03/2022;24586;26750;30;60;8;38;;46;24962
02/03/2022;24268;26814;29;59;7;37;;44;24673
03/03/2022;25121;28168;28;58;6;36;;42;25556
04/03/2022;26493;29268;27;57;5;35;;40;26840
07/03/2022;27964;30996;24;54;2;32;;34;28142
08/03/2022;28043;31268;23;53;1;31;;32;28144
09/03/2022;28511;32946;22;52;0;30;;30;28511
10/03/2022;27093;29854;21;51;1;29;;30;27185
11/03/2022;26821;28943;20;50;2;28;;30;26962
14/03/2022;25218;26496;17;47;5;25;;30;25431
15/03/2022;24375;25239;16;46;6;24;;30;24548
16/03/2022;25089;27764;15;45;7;23;;30;25713
17/03/2022;25536;28604;14;44;8;22;;30;26354
18/03/2022;25711;29193;13;43;9;21;;30;26756
21/03/2022;25736;29186;10;40;12;18;;30;27116
22/03/2022;25957;29432;9;39;13;17;;30;27463
23/03/2022;26200;29936;8;38;14;16;;30;27943
24/03/2022;26107;28789;7;37;15;15;;30;27448
25/03/2022;26100;28425;6;36;16;14;;30;27340
28/03/2022;26171;27557;3;33;19;11;;30;27049
29/03/2022;26179;27825;2;32;20;10;;30;27276
30/03/2022;26139;27725;1;31;21;9;;30;27249
31/03/2022;26736;28025;0;30;22;8;;30;27681
01/04/2022;26768;28107;29;60;7;38;;45;26976
04/04/2022;25854;27175;26;57;4;35;;39;25989
05/04/2022;25411;26325;25;56;3;34;;37;25485
06/04/2022;23936;24936;24;55;2;33;;35;23993
07/04/2022;25146;26357;23;54;1;32;;33;25183
08/04/2022;25836;27518;22;53;0;31;;31;25836
11/04/2022;25029;27096;19;50;3;28;;31;25229
12/04/2022;25832;27768;18;49;4;27;;31;26082
13/04/2022;25636;27714;17;48;5;26;;31;25971
14/04/2022;26021;28543;16;47;6;25;;31;26509
19/04/2022;26071;28571;11;42;11;20;;31;26958
20/04/2022;25532;27054;10;41;12;19;;31;26121
21/04/2022;25586;27564;9;40;13;18;;31;26415
22/04/2022;25593;28007;8;39;14;17;;31;26683
25/04/2022;25271;25782;5;36;17;14;;31;25551
26/04/2022;25218;25071;4;35;18;13;;31;25133
27/04/2022;25275;26714;3;34;19;12;;31;26157
28/04/2022;25225;26461;2;33;20;11;;31;26022
29/04/2022;26454;27843;1;32;21;10;;31;27395
03/05/2022;26661;28054;28;58;6;36;;42;26860
04/05/2022;27879;29132;27;57;5;35;;40;28036
05/05/2022;28232;29393;26;56;4;34;;38;28354
06/05/2022;28082;29182;25;55;3;33;;36;28174
09/05/2022;28536;29561;22;52;0;30;;30;28536
10/05/2022;27250;28279;21;51;1;29;;30;27284
11/05/2022;27407;28264;20;50;2;28;;30;27464
12/05/2022;27329;27636;19;49;3;27;;30;27360
13/05/2022;27200;27357;18;48;4;26;;30;27221
16/05/2022;27246;27371;15;45;7;23;;30;27275
17/05/2022;28043;28900;14;44;8;22;;30;28272
18/05/2022;28486;29986;13;43;9;21;;30;28936
19/05/2022;28211;28704;12;42;10;20;;30;28375
20/05/2022;28446;29264;11;41;11;19;;30;28746
23/05/2022;27989;28518;8;38;14;16;;30;28236
24/05/2022;27761;27432;7;37;15;15;;30;27597
25/05/2022;27679;27525;6;36;16;14;;30;27597
26/05/2022;27571;27100;5;35;17;13;;30;27304
27/05/2022;27443;26143;4;34;18;12;;30;26663
30/05/2022;27461;26129;1;31;21;9;;30;26529
31/05/2022;26682;28143;0;30;22;8;;30;27753
01/06/2022;25900;27675;29;60;7;38;;45;26176
06/06/2022;25864;27829;24;55;2;33;;35;25976
07/06/2022;24407;26139;23;54;1;32;;33;24459
08/06/2022;23343;24771;22;53;0;31;;31;23343
09/06/2022;23696;25318;21;52;1;30;;31;23748
10/06/2022;23846;26050;20;51;2;29;;31;23988
13/06/2022;22829;25193;17;48;5;26;;31;23210
14/06/2022;23800;26389;16;47;6;25;;31;24301
15/06/2022;23450;25318;15;46;7;24;;31;23872
16/06/2022;23839;26064;14;45;8;23;;31;24413
17/06/2022;24129;26436;13;44;9;22;;31;24799
20/06/2022;23579;24414;10;41;12;19;;31;23902
21/06/2022;23232;23957;9;40;13;18;;31;23536
22/06/2022;23054;22054;8;39;14;17;;31;22602
23/06/2022;23086;23379;7;38;15;16;;31;23228
24/06/2022;22946;22107;6;37;16;15;;31;22513
27/06/2022;23100;21589;3;34;19;12;;31;22174
28/06/2022;23007;20404;2;33;20;11;;31;21328
29/06/2022;23011;21429;1;32;21;10;;31;21939
30/06/2022;22186;22889;0;31;22;9;;31;22685
01/07/2022;22175;22871;30;61;8;39;;47;22293
04/07/2022;21911;22364;27;58;5;36;;41;21966
05/07/2022;20750;21139;26;57;4;35;;39;20790
06/07/2022;19429;19450;25;56;3;34;;37;19431
07/07/2022;18943;19614;24;55;2;33;;35;18981
08/07/2022;18554;18971;23;54;1;32;;33;18567
11/07/2022;18357;18521;20;51;2;29;;31;18368
12/07/2022;17057;17043;19;50;3;28;;31;17056
13/07/2022;17093;17279;18;49;4;27;;31;17117
14/07/2022;17571;18564;17;48;5;26;;31;17731
15/07/2022;18057;19489;16;47;6;25;;31;18334
18/07/2022;17179;18336;13;44;9;22;;31;17515
19/07/2022;17775;19036;12;43;10;21;;31;18182
20/07/2022;18089;19843;11;42;11;20;;31;18711
21/07/2022;17929;19464;10;41;12;19;;31;18523
22/07/2022;17950;19082;9;40;13;18;;31;18425
25/07/2022;17714;17557;6;37;16;15;;31;17633
26/07/2022;17625;17514;5;36;17;14;;31;17564
27/07/2022;17654;17311;4;35;18;13;;31;17455
28/07/2022;17629;17054;3;34;19;12;;31;17277
29/07/2022;16982;18061;2;33;20;11;;31;17678
01/08/2022;17714;18575;30;60;8;38;;46;17864
02/08/2022;16607;17546;29;59;7;37;;44;16756
03/08/2022;15961;16864;28;58;6;36;;42;16090
04/08/2022;15968;16996;27;57;5;35;;40;16097
05/08/2022;16557;17464;26;56;4;34;;38;16652
08/08/2022;16536;17343;23;53;1;31;;32;16561
09/08/2022;16482;17729;22;52;0;30;;30;16482
10/08/2022;16321;17850;21;51;1;29;;30;16372
11/08/2022;16079;16964;20;50;2;28;;30;16138
12/08/2022;15868;16921;19;49;3;27;;30;15973
15/08/2022;15471;16193;16;46;6;24;;30;15615
16/08/2022;15218;15732;15;45;7;23;;30;15338
17/08/2022;15075;15068;14;44;8;22;;30;15073
18/08/2022;15032;14654;13;43;9;21;;30;14919
19/08/2022;15068;14696;12;42;10;20;;30;14944
22/08/2022;15021;14161;9;39;13;17;;30;14648
23/08/2022;14704;12893;8;38;14;16;;30;13859
24/08/2022;14636;12946;7;37;15;15;;30;13791
25/08/2022;14629;12236;6;36;16;14;;30;13353
26/08/2022;14564;11936;5;35;17;13;;30;13075
30/08/2022;14493;9421;1;31;21;9;;30;10943
31/08/2022;10864;12114;0;30;22;8;;30;11781
01/09/2022;11532;13118;29;60;7;38;;45;11779
02/09/2022;12229;14339;28;59;6;37;;43;12523
05/09/2022;12711;14579;25;56;3;34;;37;12862
06/09/2022;13586;14936;24;55;2;33;;35;13663
07/09/2022;14346;16200;23;54;1;32;;33;14402
08/09/2022;15157;16721;22;53;0;31;;31;15157
09/09/2022;15032;16182;21;52;1;30;;31;15069
12/09/2022;15850;17914;18;49;4;27;;31;16116
13/09/2022;16275;18607;17;48;5;26;;31;16651
14/09/2022;15461;16507;16;47;6;25;;31;15663
15/09/2022;15229;16325;15;46;7;24;;31;15476
16/09/2022;14968;15593;14;45;8;23;;31;15129
20/09/2022;15679;18529;10;41;12;19;;31;16782
21/09/2022;15546;17821;9;40;13;18;;31;16500
22/09/2022;15407;18100;8;39;14;17;;31;16623
23/09/2022;15450;18986;7;38;15;16;;31;17161
26/09/2022;15293;18121;4;35;18;13;;31;16935
27/09/2022;15332;18889;3;34;19;12;;31;17512
28/09/2022;15307;17846;2;33;20;11;;31;16945
29/09/2022;15288;17492;1;32;21;10;;31;16781
30/09/2022;17407;16657;0;31;22;9;;31;16875
03/10/2022;17404;16464;28;58;6;36;;42;17270
04/10/2022;19314;18189;27;57;5;35;;40;19173
05/10/2022;19100;18107;26;56;4;34;;38;18995
06/10/2022;18511;17529;25;55;3;33;;36;18429
07/10/2022;18782;18018;24;54;2;32;;34;18737
10/10/2022;17954;17236;21;51;1;29;;30;17930
11/10/2022;17436;16950;20;50;2;28;;30;17404
12/10/2022;17236;16525;19;49;3;27;;30;17165
13/10/2022;17246;16189;18;48;4;26;;30;17105
14/10/2022;17514;16964;17;47;5;25;;30;17422
17/10/2022;17461;16629;14;44;8;22;;30;17239
18/10/2022;18057;17446;13;43;9;21;;30;17874
19/10/2022;18007;17093;12;42;10;20;;30;17702
20/10/2022;17904;16554;11;41;11;19;;30;17409
21/10/2022;17843;16654;10;40;12;18;;30;17367
24/10/2022;17768;15657;7;37;15;15;;30;16713
25/10/2022;17721;15032;6;36;16;14;;30;16287
26/10/2022;17682;14282;5;35;17;13;;30;15755
27/10/2022;17639;13482;4;34;18;12;;30;15145
28/10/2022;17632;13318;3;33;19;11;;30;14900
31/10/2022;11943;11796;0;30;22;8;;30;11835
01/11/2022;12961;12504;29;60;7;38;;45;12890
02/11/2022;14064;13404;28;59;6;37;;43;13972
03/11/2022;13296;12700;27;58;5;36;;41;13223
04/11/2022;13718;12968;26;57;4;35;;39;13641
07/11/2022;13200;12289;23;54;1;32;;33;13172
08/11/2022;13079;12196;22;53;0;31;;31;13079
09/11/2022;13536;12646;21;52;1;30;;31;13507
10/11/2022;13843;12964;20;51;2;29;;31;13786
11/11/2022;14300;13639;19;50;3;28;;31;14236
14/11/2022;14150;14007;16;47;6;25;;31;14122
15/11/2022;13764;13236;15;46;7;24;;31;13645
16/11/2022;13511;12496;14;45;8;23;;31;13249
17/11/2022;13289;11829;13;44;9;22;;31;12865
18/11/2022;13218;11554;12;43;10;21;;31;12681
21/11/2022;13293;12029;9;40;13;18;;31;12763
22/11/2022;13029;11321;8;39;14;17;;31;12258
23/11/2022;13050;11614;7;38;15;16;;31;12355
24/11/2022;13036;11929;6;37;16;15;;31;12465
25/11/2022;13061;12196;5;36;17;14;;31;12587
28/11/2022;13075;12350;2;33;20;11;;31;12607
29/11/2022;13104;12314;1;32;21;10;;31;12569
30/11/2022;12746;10836;0;31;22;9;;31;11391
01/12/2022;12721;10704;30;61;8;39;;47;12378
02/12/2022;12668;10914;29;60;7;38;;45;12395
05/12/2022;12804;11568;26;57;4;35;;39;12677
06/12/2022;12889;11639;25;56;3;34;;37;12788
07/12/2022;12729;11418;24;55;2;33;;35;12654
08/12/2022;13236;12029;23;54;1;32;;33;13199
09/12/2022;13314;12668;22;53;0;31;;31;13314
12/12/2022;13114;12439;19;50;3;28;;31;13049
13/12/2022;13350;12818;18;49;4;27;;31;13281
14/12/2022;13425;12914;17;48;5;26;;31;13343
15/12/2022;13386;12507;16;47;6;25;;31;13216
16/12/2022;13325;11721;15;46;7;24;;31;12963
19/12/2022;13354;11354;12;43;10;21;;31;12709
20/12/2022;13414;12096;11;42;11;20;;31;12946
21/12/2022;13404;11743;10;41;12;19;;31;12761
22/12/2022;13396;11214;9;40;13;18;;31;12481
23/12/2022;10986;10979;8;39;14;17;;31;10983
28/12/2022;11039;11100;3;34;19;12;;31;11076
29/12/2022;10964;11096;2;33;20;11;;31;11049
30/12/2022;10664;10929;1;32;21;10;;31;10844
03/01/2023;10418;10425;28;56;6;34;;40;10419
04/01/2023;9950;10264;27;55;5;33;;38;9991
05/01/2023;9743;10382;26;54;4;32;;36;9814
06/01/2023;10068;10607;25;53;3;31;;34;10116
09/01/2023;9646;9954;22;50;0;28;;28;9646
10/01/2023;9029;9550;21;49;1;27;;28;9048
11/01/2023;8943;9718;20;48;2;26;;28;8998
12/01/2023;9025;9836;19;47;3;25;;28;9112
13/01/2023;8932;9911;18;46;4;24;;28;9072
16/01/2023;9193;10832;15;43;7;21;;28;9603
17/01/2023;9071;10014;14;42;8;20;;28;9340